border_size=1
usage=map

Ybz         , Ybz         , Ybz         , Ybz         , Ybz         , Ybz         , Ybz         , Ybz         , Ybz         , Ybz         , Ybz         , Ybz         , Ybz         , Ybz         , Ybz         , Ybz         , Ybz         , Ybz         , Ybz         , Ybz         , Ybz         , Ybz         , Ybz         
Ybz         , Ybz         , Ybz         , Ybz         , Ybz         , Ybz         , Ybz         , Ybz         , Ybz         , Ybz         , Ybz         , Ybz         , Ybz         , Ybz         , Ybz         , Ybz         , Ybz         , Ybz         , Ybz         , Ybz         , Ybz         , Ybz         , Ybz         
Ybx         , Ybz         , Ybx         , Ybz         , Ybx         , Ybz         , Ybx         , Ybz         , Ybx         , Ybz         , Ybx         , Ybz         , Ybx         , Ybz         , Ybx         , Ybz         , Ybx         , Ybz         , Ybz         , Ybz         , Ybz         , Ybz         , Ybz         
Ybw         , Yby         , Ybw         , Yby         , Ybw         , Yby         , Ybw         , Yby         , Ybw         , Yby         , Ybw         , Yby         , Ybw         , Yby         , Ybw         , Yby         , Ybw         , Yby         , Ybz         , Ybz         , Ybz         , Ybz         , Ybz         
Ybf         , Ybf         , Ybf         , Ybf         , Ybf         , Ybf         , Ybf         , Ybf         , Ybf         , Ybf         , Ybf         , Ybf         , Ybf         , Ybf         , Ybf         , Ybf         , Ybf         , Ybf         , Ybz         , Ybz         , Ybz         , Ybz         , Ybz         
Ybf         , Ybf         , Ybf         , Ybf         , Ybf         , Ybf         , Ybf         , Ybf         , Ybf         , Ybf         , Ybf         , Ybf         , Ybf         , Ybf         , Ybf         , Ybf         , Ybf         , Ybf         , Ybz         , Ybz         , Ybz         , Ybz         , Ybz         
Ybf         , Ybf         , Ybf         , Ybf         , Ybf         , Ybf         , Ybf         , Ybf         , Ybf         , Ybf         , Ybf         , Ybf         , Ybf         , Ybf         , Ybf         , Ybf         , Ybf         , Ybf         , Ybz         , Ybz         , Ybz         , Ybz         , Ybz         
Ybf         , Ybf         , Ybf         , Ybf         , Ybf         , Ybf         , Ybf         , Ybf         , Ybf         , Ybf         , Ybf         , Ybf         , Ybf         , Ybf         , Ybf         , Ybf         , Ybf         , Ybf         , Ybz         , Ybz         , Ybz         , Ybz         , Ybz         
Ybz         , Ybz         , Ybz         , Ybz         , Ybz         , Ybz         , Ybz         , Ybz         , Ybz         , Ybz         , Ybz         , Ybz         , Ybz         , Ybz         , Ybz         , Ybz         , Ybz         , Ybz         , Ybz         , Ybz         , Ybz         , Ybz         , Ybz         
Ybz         , Ybz         , Ybz         , Ybz         , Ybz         , Ybz         , Ybz         , Ybz         , Ybz         , Ybz         , Ybz         , Ybz         , Ybz         , Ybz         , Ybz         , Ybz         , Ybz         , Ybz         , Ybz         , Ybz         , Ybz         , Ybz         , Ybz         
Ybz         , Ybz         , Ybz         , Ybz         , Ybz         , Ybz         , Ybz         , Ybz         , Ybz         , Ybz         , Ybz         , Ybz         , Ybz         , Ybz         , Ybz         , Ybz         , Ybz         , Ybz         , Ybz         , Ybz         , Ybz         , Ybz         , Ybz         
Ybz         , Ybz         , Ybz         , Ybz         , Ybz         , Ybz         , Ybz         , Ybz         , Ybz         , Ybz         , Ybz         , Ybz         , Ybz         , Ybz         , Ybz         , Ybz         , Ybz         , Ybz         , Ybz         , Ybz         , Ybz         , Ybz         , Ybz         
Ybz         , Ybz         , Ybz         , Ybz         , Ybz         , Ybz         , Ybz         , Ybz         , Ybz         , Ybz         , Ybz         , Ybz         , Ybz         , Ybz         , Ybz         , Ybz         , Ybz         , Ybz         , Ybz         , Ybz         , Ybz         , Ybz         , Ybz         
