border_size=1
usage=map

Ha          , Ha          , Aa^Fda      , Gg          , Ms          , Gg          , Ms          , Ms          , Md          , Mm          , Mm          , Wo          , Mm          , Md          , Hh          , Gg          , Hh          , Md          , Md          , Hh          , Mm^Xm       , Mm^Xm       , Mm^Xm       , Hh          , Md          , Hh          , Hh^Fp       , Hh          , Hh          , Hh          , Hh          , Mm          , Ms          , Ms          , Ms          , Ms          , Hhd^Fmf     , Hh          , Hh          , Hh          
Md          , Ha          , Ha          , Ms          , Aa^Fda      , Mm          , Mm          , Mm          , Mm          , Md          , Hh          , Wo          , Hh          , Hh          , Hh          , Gg          , Hh          , Hh          , Md          , Md          , Md          , Md          , Mm^Xm       , Md          , Hhd^Fmf     , Hh^Fp       , Hh          , Hh          , Hh^Fp       , Hh^Fp       , Hh^Fp       , Mm          , Mm          , Ms          , Ms          , Ms          , Hh          , Hh          , Hh          , Hhd^Fmf     
Mm          , Mm          , Md          , Ha          , Md          , Mm          , Hh^Fp       , Md          , 3 Kh^Kov    , Chr         , Ch          , Wo          , Wo          , Gs^Fmf      , Gg          , Gg          , Md          , Hh^Fp       , Md          , Mm^Xm       , Md          , Md          , Hh^Fp       , Md          , Hh^Fp       , Hh          , Hhd^Fmf     , Hh^Fp       , Hh^Fp       , Hh          , Hh          , Mm          , Mm          , Ms          , Md          , Md          , Md          , Hh^Fp       , Hh^Fp       , Hh          
Hh          , Hh          , Mm          , Md          , Mm          , Hh          , Hh          , Hhd^Fmf     , Mm          , Mm          , Chr         , Hh          , Ww^Bw/      , Gg          , Hh          , Hh          , Md          , Md          , Mm^Xm       , Md          , Hh          , Hh          , Hh          , Hh^Fp       , Hh          , Hh          , Hh          , Hh          , Hh^Fp       , Mm          , Mm          , Mm          , Ms          , Ms          , Ms          , Md          , Md          , Hh          , Hh^Fms      , Hh          
Mm          , Hh          , Mm          , Mm          , Mm          , Mm          , Mm          , Hh          , Gg          , Chr         , Gs^Fmf      , Gg          , Gg          , Ww          , Hhd^Fmf     , Hh^Fp       , Hhd^Fmf     , Md          , Md          , Md          , Hh          , Hh          , Hh^Fp       , Hh          , Hh          , Hh          , Hh          , Mm          , Hh          , Hh          , Mm          , Ms          , Ms          , Ms          , Ms          , Ms          , Md          , Md          , Hh          , Hh          
Mm          , Mm          , Mm          , Mm          , Mm          , Mm          , Mm          , Mm          , Mm          , Gg          , Gg          , Gs^Fmf      , Ww          , Ww          , Hh          , Hh          , Hhd^Fmf     , Hh^Fp       , Hh          , Hh          , Hh          , Hh^Fp       , Hh          , Hh^Vo       , Hh          , Gg          , Gg          , Hh          , Mm          , Mm          , Mm          , Mm          , Ms          , Ms          , Ms          , Ms          , Md          , Md          , Md          , Hh          
Ww          , Mm          , Mm          , Mm          , Mm          , Mm          , Hh          , Mm          , Hh          , Mm          , Gs^Fmf      , Ww^Bw\      , Gg          , Gg          , Gg          , Hh          , Hhd^Fmf     , Hh          , Hh^Fp       , Hh          , Hh          , Hh^Fp       , Hh          , Hh^Fp       , Gg          , Gg          , Gg          , Mm          , Mm          , Mm          , Mm          , Mm          , Mm          , Ms          , Ms          , Ms          , Md          , Md          , Md          , Hh          
Hh^Fp       , Ww          , Wo          , Wo          , Wo          , Mm          , Hh^Fp       , Hh^Fp       , Gs^Fmf      , Hh^Fp       , Ww          , Ww          , Gg          , Gg          , Gg          , Gg          , Hh^Fp       , Hh          , Hh          , Hh^Fp       , Hh^Fp       , Hh          , Gg          , Gg          , Gg          , Gg          , Gg          , Hh^Fdf      , Hh^Fdf      , Hh^Fdf      , Hh^Fmf      , Mm          , Mm          , Mm          , Mm          , Ms          , Md          , Md          , Md          , Md          
Hh^Fp       , Hh^Fp       , Mm          , Mm          , Mm          , Wo          , Ww          , Hh          , Ww          , Ww          , Hh^Fp       , Gg          , Hh^Fp       , Gg          , Gg          , Gg          , Hh^Fp       , Gg          , Hh^Fp       , Hh^Fmf      , Hh^Fdf      , Gg          , Gg          , Gg          , Gg          , Gg          , Gg          , Hh^Fdf      , Hh          , Hh          , Mm          , Mm          , Mm          , Mm          , Mm          , Ms          , Ms          , Md          , Hhd^Fmf     , Hh^Fp       
Hh^Fp       , Hh^Fp       , Mm          , Mm          , Mm          , Hh          , Hh^Fp       , Ww          , Hh^Fp       , Hh^Fp       , Hh^Fdf      , Hh^Fdf      , Hh^Fp       , Hh^Fmf      , Hh^Fmf      , Hh^Fp       , Hh          , Hh^Fmf      , Hh^Fp       , Hh^Fp       , Hh          , Gg          , Gg          , Gg          , Gg          , Gg          , Gg          , Gg          , Gg          , Gg          , Hh^Fdf      , Mm          , Hh^Fdf      , Mm          , Mm          , Mm          , Mm          , Md          , Ms          , Hh          
Hh^Fp       , Hh^Fp       , Hh          , Mm          , Mm          , Hh          , Hh^Fmf      , Hh^Fp       , Hh^Fmf      , Hh^Fmf      , Hh^Fp       , Hh^Fp       , Hh^Fdf      , Hh^Fdf      , Hh^Fp       , Hh^Fp       , Hh          , Hh          , Mm          , Hh          , Hh^Fp       , Gg          , Gg          , Gg          , Gg          , Gg          , Gg          , Gg          , Gg          , Gg          , Hh^Fdf      , Hh^Fdf      , Hh          , Hh^Fmf      , Hh^Fmf      , Mm          , Mm          , Mm          , Mm          , Md          
Hh          , Hh^Fp       , Mm          , Mm          , Hh          , Hh^Fp       , Hh^Fp       , Hh^Fp       , Hh^Fmf      , Hh^Fp       , Hh^Fp       , Hh^Fmf      , Hh^Fmf      , Hh^Fmf      , Hh^Fp       , Hh          , Hh^Fp       , Mm          , Mm          , Hh          , Hh          , Gg          , Gg          , Gg          , Gg          , Gg^Vo       , Gg          , Gg          , Gg^Vo       , Gg          , Gg          , Hh          , Ce          , Hh          , Hh          , Hh^Fp       , Hh^Fmf      , Hh          , Ww          , Ww          
Hh          , Mm          , Mm          , Mm          , Hh          , Hh^Fp       , Hh          , Hh^Fp       , Hh^Fmf      , Hh^Fmf      , Hh^Fmf      , Gg          , Hh^Fp       , Hh^Fmf      , Gg          , Hh^Fp       , Hh^Fmf      , Mm          , Mm          , Mm          , Hh          , Hh^Fmf      , Hh^Fmf      , Gg          , Gg          , Gg          , Gg          , Gg          , Gg          , Gg          , Gg          , Gg          , Ce          , Hh^Fp       , 2 Ke        , Hh          , Ww          , Ww          , Mm          , Md          
Hh          , Hh^Fp       , Mm          , Mm          , Hh          , Hh          , Hh          , Hh          , Hh^Fp       , Hh^Fp       , Hh^Fmf      , Hh^Fp       , Hh^Fp       , Hh^Fp       , Hh^Fp       , Hh          , Hh^Fmf      , Hh          , Hh^Fdf      , Mm          , Hh          , Hh^Fp       , Gg          , Hh^Fdf      , Gg          , Gg          , Gg          , Gg          , Gg          , Gg          , Gg          , Gg          , Gg          , Ce          , Ww          , Ww          , Hh          , Mm          , Mm          , Md          
Mm^Xm       , Mm^Xm       , Mm          , Hh^Fp       , Hh          , Hh^Fp       , Hh^Fp       , Hh^Fp       , Hh^Fp       , Hh^Fp       , Hh^Fdf      , Hh^Fmf      , Hh^Fmf      , Hh^Fp       , Hh^Fp       , Gg^Es       , Gg^Es       , Hh          , Gg          , Hh^Fdf      , Gg          , Gg          , Gg          , Gg          , Gg          , Gg          , Gg          , Gg^Vo       , Gg          , Gg          , Gg          , Gg          , Gg          , Gg          , Ww          , Hh^Fms      , Gd^Vo       , Mm          , Mm          , Md          
Mm          , Mm^Xm       , Hh^Fp       , Hh          , Hh          , Hh          , Gg          , Hh^Fp       , Hh^Fp       , Hh^Fp       , Hh^Fp       , Hh^Fdf      , Hh^Fp       , Hh^Fp       , Gg^Es       , Gg^Es       , Ww          , Gg^Es       , Ww          , Gg          , Gg          , Gg^Vo       , Gg          , Gg          , Gg          , Gg          , Gg          , Gg          , Ww          , Gg          , Gg          , Gg          , Gg          , Gg^Es       , Ww          , Gg^Es       , Gg          , Hh^Fms      , Hh^Fmf      , Hh          
Mm^Xm       , Mm          , Hh^Fp       , Gg          , Gg          , Gg          , Ww          , Gg          , Ww          , Ww          , Ww          , Hh^Fp       , Hh^Fdf      , Hh^Fp       , Ww          , Ww          , Gg^Es       , Ww          , Ww          , Ww          , Ww          , Gg          , Gg          , Gg          , Ww          , Gg          , Ww          , Ww          , Gg          , Ww          , Ww          , Gg          , Gg          , Gg          , Ww          , Gg          , Gd^Vo       , Hh^Fmw      , Hh          , Hh          
Mm          , Mm          , Ww          , Ww          , Ww          , Ww          , Gg          , Ww          , Hh^Fmf      , Hh^Fp       , Hh^Fp       , Ww          , Ww          , Ww          , Gg^Es       , Gg^Es       , Gg^Es       , Gg          , Gg          , Ww          , Gg          , Ww          , Ww          , Ww          , Ww          , Ww          , Gg          , Gg          , Gg          , Gg          , Gg          , Ww          , Ww          , Ww          , Ww          , Hh          , Hh          , Hh          , Hh          , Hh          
Ww          , Ww          , Gg          , Gg          , Hh^Fdf      , Hh^Fp       , Hh^Fp       , Hh^Fdf      , Hh^Fmf      , Hh^Fp       , Hh^Fdf      , Hh^Fp       , Hh          , Hh          , Hh          , Hh          , Hh          , Gg          , Gg          , Gg          , Gg          , Gg          , Gg          , Ww          , Gg          , Gg          , Gg          , Gg^Vo       , Gg          , Gg          , Gg          , Gg          , Hh          , Ww          , Gg          , Gg          , Hh          , Hh^Fp       , Md          , Hh          
Mm          , Mm          , Mm          , Hh^Fp       , Hh^Fdf      , Hh^Fp       , Hh^Fmf      , Hh^Fp       , Hh^Fp       , Hh^Fp       , Mm          , Hh^Fp       , Hh          , Hh^Fp       , Hh          , Mm          , Mm          , Hh^Fp       , Hh          , Gg          , Gg          , Gg          , Hh          , Gg          , Gg          , Gg          , Gg          , Gg          , Gg          , Gg          , Hh          , Gg          , Hh^Fp       , Hh          , Hhd^Fmf     , Gg          , Gg          , Hh^Fp       , Md          , Md          
Mm          , Mm^Xm       , Mm          , Hh^Fp       , Mm^Xm       , Hh^Fp       , Hh^Fp       , Hh^Fmf      , Hh^Fp       , Hh^Fp       , Mm          , Mm          , Hh          , Hh^Fp       , Mm          , Mm          , Mm          , Mm          , Mm          , Gg          , Hh          , Mm          , Mm          , Hh          , Hh^Fp       , Hh^Fp       , Hh^Fp       , Gg          , Gg          , Hh          , Hh^Fp       , Hh^Fp       , Hh^Fp       , Hh          , Mm          , Hh^Fp       , Gg          , Gg          , Hh          , Md          
Mm          , Mm          , Mm          , Mm^Xm       , Mm^Xm       , Hh^Fmf      , Hh^Fdf      , Hh^Fdf      , Hh^Fp       , Hh^Fp       , Hh          , Hh          , Hh          , Mm          , Mm          , Hh^Fp       , Mm          , Mm          , Hh          , Hh          , Mm          , Mm          , Mm          , Mm          , Hh          , Hh          , Hh          , Hh          , Hh          , Hh^Fp       , Mm          , Mm          , Hh^Fp       , Hh          , Mm          , Mm          , Hh          , Gg          , Hh^Fp       , Hh          
Mm          , Mm^Xm       , Mm          , Mm          , Hh^Fp       , Hh^Fdf      , Hh^Fp       , Hh^Fp       , Hh^Fp       , Hh^Fdf      , Hh          , Hh          , Hh          , Hh          , Hh          , Hh^Fp       , Hh^Fp       , Hh          , Gg          , Hh          , Hh^Vhh      , Mm          , Hh          , Mm          , Hh^Fp       , Hh^Fp       , Hh          , Hh          , Hh          , Hh          , Mm          , Mm          , Mm          , Mm          , Mm          , Mm          , Hh^Fp       , Hh          , Hh          , Hh          
Mm          , Mm          , Mm^Xm       , Mm^Xm       , Hh^Fp       , Hh^Fp       , Hh^Fp       , Hh^Fp       , Hh^Fp       , Hh^Fp       , Hh          , Hh          , Hh^Fp       , Hh^Fp       , Hh          , Hh          , Hh^Fp       , Hh^Fp       , Gg          , Gg          , Gg          , Hh^Fp       , Hh^Fmf      , Hh          , Hh          , Hh^Fp       , Mm          , Hh          , Mm          , Mm          , Mm          , Hh          , Hh          , Hh          , Gg          , Hh^Fp       , Md          , Hh^Fp       , Md          , Hh          
Mm          , Mm          , Mm^Xm       , Mm^Xm       , Hh^Fp       , Hh^Fp       , Hh^Fdf      , Hh^Fp       , Hh^Fp       , Hh^Fp       , Hh^Fdf      , Hh          , Hh          , Hh          , Hh^Fmf      , Hh          , Hh          , Gg          , Gg          , Gg          , Gg          , Hh^Fmf      , Gg          , Hh^Fdf      , Hh^Fp       , Mm          , Mm          , Mm          , Mm          , Mm          , Hh^Fms      , Hh^Fp       , Hh^Fp       , Gg          , Gg          , Gg          , Hh^Fp       , Md          , Ww          , Ww          
Mm          , Mm          , Mm          , Hh^Fp       , Hh^Fp       , Hh^Fdf      , Hh^Fp       , Hh^Fp       , Hh^Fp       , Hh^Fp       , Hh^Fdf      , Hh^Fdf      , Hh^Fmf      , Hh^Fmf      , Hh^Fmf      , Hh^Fmf      , Gg          , Gg          , Gg          , Gg          , Gg          , Gg          , Gg          , Gg          , Gg          , Hh          , Hh^Fp       , Mm          , Mm          , Mm          , Hh^Fmf      , Hh^Fdf      , Gg^Es       , Gg          , Ww          , Gg          , Ww          , Ww          , Hh          , Md          
Mm^Xm       , Mm^Xm       , Mm          , Hh^Fp       , Hh^Fp       , Hh^Fp       , Hh^Fdf      , Hh^Fp       , Mm          , Mm          , Hh^Fp       , Hh          , Gg          , Gg^Vh       , Gg          , Gg          , Gg^Fet      , Gg          , Gg^Vh       , Gg          , Gg          , Gg          , Ww^Es       , Gg          , Gg^Efm      , Gg          , Hh^Vhh      , Hh          , Hh          , Mm          , Hh^Fmf      , Hh^Fms      , Ww          , Ww          , Gg          , Ww          , Md          , Md          , Md          , Md          
Mm^Xm       , Mm          , Hh^Fdf      , Hh^Fp       , Hh^Fp       , Hh^Fp       , Mm          , Hh^Fdf      , Mm          , Mm          , Hh^Fp       , Gg          , Gg          , Gg          , Ww          , Gg^Efm      , Ww          , Gg^Efm      , Gg          , Gg          , Gg^Efm      , Ww^Es       , Hh^Fdf      , Ww^Es       , Ww^Es       , Gg          , Gg          , Gg          , Wo          , Wo          , Ww          , Ww          , Gg          , Gg          , Gg          , Gg^Es       , Hh^Fp       , Hhd^Fmf     , Md          , Md          
Ww          , Mm^Xm       , Hh^Fdf      , Hh^Fp       , Hh^Fdf      , Hh          , Mm          , Mm          , Hh^Fp       , Hh^Fp       , Gg^Vh       , Gg          , Gg^Efm      , Ww          , Ww          , Ww          , Ww          , Gg^Efm      , Gg          , Gg          , Ww^Es       , Ww^Es       , Hh^Fmf      , Ww^Es       , Ww^Es       , Ww^Es       , Wwr         , Wo          , Hh^Fmf      , Hh^Fmf      , Mm          , Mm          , Mm          , Hh^Fp       , Mm          , Hh^Fp       , Hh^Fp       , Hh^Fp       , Hh^Fp       , Md          
Mm^Xm       , Ww          , Ww          , Hh^Fp       , Hh^Fdf      , Hh          , Hh^Fp       , Mm          , Gs^Fmf      , Hh^Fdf      , Gg          , Gg          , Ww          , Ww          , Ww          , Ww          , Ww          , Ww          , Gg^Efm      , Gg^Efm      , Ww          , Ww^Es       , Ww          , Hh^Fmf      , Ww          , Ww          , Gs^Fdf      , Hh^Fms      , Mm          , Mm          , Mm          , Mm          , Mm          , Mm          , Mm          , Mm          , Hh^Fp       , Hhd^Fmf     , Md          , Hh^Fp       
Mm^Xm       , Gs^Fmf      , Hh^Fp       , Ww          , Ww          , Ww          , Ww          , Gs^Fmf      , Hh^Fp       , Gg          , Ww          , Wwr         , Gg^Efm      , Ww          , Ce          , Ww          , Ce          , Ww          , Wwr         , Wwr         , Gg^Fet      , Ww          , Gg^Efm      , Ww          , Gg^Efm      , Gg          , Gg          , Gs^Fmf      , Gg          , Hh^Fmf      , Hh^Fmf      , Mm          , Hh^Fms      , Hh^Fmf      , Hh^Fms      , Mm          , Hh          , Md          , Hh          , Hh^Fp       
Mm^Xm       , Mm^Xm       , Mm          , Hh^Fp       , Hh          , Hh          , Hh^Fmf      , Ww          , Ww          , Ww          , Gg          , Gg^Efm      , Gg          , Gg          , Gg          , 1 Ce^Kov    , Gg          , Ww          , Gg^Efm      , Gg^Efm      , Gg^Efm      , Gg^Efm      , Gg          , Gg          , Gg          , Gg^Vh       , Gg          , Gg          , Gg          , Hh^Fp       , Gg          , Gg          , Gg          , Hh^Fdf      , Hh^Fdf      , Hh          , Hh          , Hhd^Fmf     , Hh          , Hh^Fp       
Mm^Xm       , Mm          , Hh^Fp       , Mm          , Hh^Fmf      , Gs^Fmf      , Hh^Fp       , Hh^Fmf      , Hh^Fmf      , Gs^Fmf      , Hh^Fmf      , Gg          , Gg          , Gg          , Gg          , Gg          , Hh^Fmf      , Gg          , Gg          , Gg          , Hh^Fmf      , Gg          , Gg          , Gg          , Gg          , Gg          , Hh^Fmf      , Gg          , Hh^Fp       , Gg          , Gg          , Gg          , Hh          , Gg          , Hh^Fmf      , Hh^Fp       , Hhd^Fdf     , Md          , Md          , Hh          
Mm^Xm       , Mm^Xm       , Mm          , Hh^Fp       , Hhd^Fdf     , Gs^Fmf      , Mm          , Mm          , Hh^Fmf      , Hh^Fp       , Mm          , Mm          , Mm          , Gg          , Gg          , Mm          , Mm          , Gs^Fmf      , Hh^Fmf      , Hh^Fmf      , Mm          , Mm          , Mm          , Hhd^Fmf     , Hh^Fp       , Hh^Fp       , Mm          , Gg          , Hh^Fmf      , Hh^Fdf      , Mm          , Hh^Fp       , Hh^Fmf      , Gg          , Hh          , Gg          , Gg          , Hhd^Fdf     , Hhd^Fmf     , Md          
Mm^Xm       , Mm          , Mm          , Mm          , Hh^Fmf      , Hh^Fmf      , Hh^Fmf      , Mm          , Mm          , Hh^Fmf      , Hh^Fmf      , Hh^Fmf      , Hh^Fmf      , Gg          , Gg          , Hh^Fmf      , Hh^Fmf      , Hh^Fdf      , Hh^Fmf      , Hh^Fmf      , Hh          , Mm          , Mm          , Mm          , Mm          , Mm          , Mm          , Mm          , Mm          , Mm          , Hh          , Mm          , Md          , Hh^Fdf      , Hh^Fp       , Gg          , Gg          , Hhd^Fdf     , Hh          , Md          
Md          , Md          , Md          , Hh          , Hh          , Gg          , Gg          , Gg          , Gg          , Hh^Fp       , Hh^Fp       , Hh^Fp       , Hh^Fp       , Gg          , Gg          , Gg          , Gg          , Gg          , Gg          , Gg          , Gg          , Hh          , Hh          , Hh          , Hh          , Hh          , Hh          , Hh          , Hh          , Hh          , Md          , Mm^Xm       , Md          , Hh          , Hh^Fp       , Hh^Fp       , Hh^Fp       , Gg          , Hh          , Hh          
Md          , Md          , Md          , Hh          , Hhd^Fdf     , Hh          , Gg          , Gg          , Hhd^Fdf     , Hh^Fp       , Hh^Fp       , Hhd^Fmf     , Hhd^Fdf     , Hh^Fp       , Gg          , Gg          , Gg          , Gg          , Gg          , Gg          , Gg          , Gg          , Gg          , Gg          , Gg          , Gg          , Hh          , Hh          , Hh          , Md          , Md          , Mm^Xm       , Mm^Xm       , Md          , Md          , Hhd^Fmf     , Md          , Hh          , Hh          , Hh          
Md          , Md          , Md          , Md          , Md          , Hhd^Fdf     , Md          , Hh^Fp       , Hh^Fp       , Hh^Fp       , Hhd^Fmf     , Hh^Fp       , Hhd^Fmf     , Hh          , Hh          , Hh          , Hh          , Gg          , Gg          , Gg          , Gg          , Gg          , Hh          , Hh          , Gg          , Gg          , Hh          , Hh          , Hh          , Md          , Hh          , Md          , Md          , Mm^Xm       , Md          , Md          , Md          , Md          , Hh          , Hh          
Md          , Md          , Md          , Md          , Gg          , Md          , Md          , Hh^Fp       , Hh^Fp       , Hh^Fp       , Hh^Fp       , Hh^Fp       , Hh^Fp       , Hh^Fp       , Hh          , Hh          , Hh          , Hh          , Hh          , Hh          , Hh          , Hh          , Hh          , Hh          , Hh          , Hh          , Hh          , Hh          , Hh          , Hh          , Hh          , Md          , Md          , Md          , Gg          , Md          , Gg          , Md          , Hh          , Hh          
