border_size=1
usage=map

Mm          , Gg          , Hh          , Hh          , Mm          , Hh          , Hh          , Rd          , Hh          , Ww          , Ww          , Mm          , Mm          , Hh          , Hh          , Hh          , Gll^Fp      , Gll^Fp      , Gll^Fp      , Rd          , Gll^Fp      , Mm          , Mm          , Mm          , Mm          , Hh          , Gll^Fp      , Gll^Fp      , Rd          , Gll^Fp      , Hh^Fp       , Hh          , Hh          , Mm          , Mm          , Mm          , Mm          , Mm          , Mm          , Mm          , Ww          , Mm          , Mm          , Mm          , Mm          , Hh          
Mm          , Mm          , Mm          , Mm          , Mm          , Hh^Fp       , Hh^Fp       , Rd          , Ww          , Hh^Fp       , Hh^Fp       , Ww          , Mm          , Mm          , Hh          , Hh^Fp       , Hh^Fp       , Gll^Fp      , Gll^Fp      , Rd          , Gll^Fp      , Mm          , Mm          , Mm          , Mm          , Hh^Fp       , Hh^Fp       , Rd          , Gll^Fp      , Gll^Fp      , Hh^Fp       , Hh          , Ce          , Mm          , Mm          , Mm          , Mm          , Mm          , Mm          , Mm          , Ww          , Mm          , Mm          , Mm          , Mm          , Hh          
Mm          , Mm          , Mm          , Mm          , Mm          , Hhd^Fmf     , Gs^Vh       , Rd          , Gs^Fp       , Ww          , Hh^Fdf      , Ww          , Ww          , Hh          , Hh          , Hh          , Hh^Vhh      , Hh^Fmf      , Hh          , Rd          , Hh^Fp       , Hh^Fp       , Gs^Fmf      , Mm          , Gs^Fdf      , Hh          , Hh          , Rd          , Hh          , Hh^Fp       , Hh^Fp       , Hh          , Ce          , 3 Ke        , Hh          , Mm          , Hh^Fp       , Hh^Fp       , Hh          , Hh          , Ww          , Hh          , Hh          , Mm          , Hh          , Hh          
Hh          , Hh          , Hh          , Mm          , Hh          , Hh^Fp       , Gg          , Rd          , Rd          , Gs^Fp       , Gg          , Gg          , Gg^Efm      , Ww          , Ww          , Gs^Fp       , Gg^Efm      , Gs^Fp       , Gg          , Rd          , Rd          , Hh^Fp       , Gg          , Hh^Fp       , Gg^Vh       , Gg          , Rd          , Rd          , Gg          , Hh^Fp       , Gg          , Gg          , Gg          , Gg          , Hh          , Hh          , Hh          , Hh^Fdf      , Hh          , Gg          , Ww          , Hh          , Hh          , Hh          , Hh^Fp       , Hh          
Hh          , Hh^Fmf      , Gg          , Hh          , Gg          , Gg          , Gg          , Gg          , Gg          , Rd          , Rd          , Gg^Vh       , Gg          , Gg          , Rd          , Ww          , Gg          , Gg          , Rd          , Rd          , Gg          , Rd          , Rd          , Gg          , Rd          , Rd          , Gg          , Gg          , Gg          , Gg          , Gg          , Gg          , Gg          , Gg          , Hh^Fp       , Hh^Fp       , Hh^Fdf      , Hh          , Ww          , Ww          , Gg          , Hh          , Hh^Fp       , Hh^Fp       , Hh^Fp       , Hh^Fp       
Gg          , Hh^Fp       , Hh          , Hh^Fmf      , Hh^Fp       , Gg          , Gg          , Gg          , Rd          , Rd          , Gg          , Rd          , Rd          , Rd          , Gg          , Ww^Bw\      , Rd          , Rd          , Gg^Efm      , Gg^Efm      , Ww          , Gg          , Gg          , Rd          , Gg          , Gg          , Gg          , Gg          , Hh^Fp       , Hh^Fp       , Hh          , Hh          , Hh          , Hh^Fp       , Hh^Fmf      , Hh^Fmf      , Ww          , Ww          , Ww          , Ww          , Gg          , Hh^Fp       , Hh          , Gll^Fp      , Gll^Fp      , Gll^Fp      
Gll^Fp      , Gll^Fp      , Gll^Fp      , Hh^Fp       , Hh^Fp       , Hh^Fp       , Rd          , Rd          , Gg          , Gg          , Gg          , Gg          , Gg          , Gg^Vh       , Gg          , Ww          , Gg          , Gg          , Ww          , Ww          , Ww          , Ww          , Gg          , Rd          , Gg          , Gg^Vh       , Hh          , Hh          , Mm          , Hh^Fp       , Mm          , Hh^Fdf      , Mm          , Hh          , Hh          , Hh          , Ww          , Ww          , Ww          , Ww          , Gg          , Hh^Fp       , Hh^Fp       , Hh^Fp       , Rd          , Rd          
Gll^Fp      , Gll^Fp      , Gll^Fp      , Hh^Fp       , Rd          , Rd          , Hh^Fp       , Gg          , Gg          , Gg          , Hh^Fmf      , Gg          , Gg^Efm      , Gg^Efm      , Ww          , Ww          , Ww          , Ww          , Hh^Fp       , Hh^Fp       , Ww          , Ww          , Gg          , Rd          , Gg          , Gs^Fp       , Hh^Fmf      , Hh          , Mm          , Mm          , Mm          , Mm          , Gs^Fmf      , Hh^Fdf      , Ww          , Ww          , Gg          , Gg          , Gg          , Gg          , Gg          , Hh^Fp       , Rd          , Rd          , Gll^Fp      , Gll^Fp      
Rd          , Gll^Fp      , Gll^Fp      , Gll^Fp      , Rd          , Hh^Fp       , Hh          , Gg^Efm      , Gg^Efm      , Hh          , Ww          , Ww          , Ww          , Ww          , Hh          , Hh          , Hh          , Hh          , Hh          , Hh^Fdf      , Hh          , Ww          , Ww          , Rd          , Gs^Fp       , Gs^Fp       , Hh^Fmf      , Hh          , Hh          , Mm          , Hh^Fdf      , Hh          , Ww          , Ww          , Gg          , Gg          , Gg^Vh       , Gg          , Gg          , Gg          , Rd          , Rd          , Hh^Fp       , Hh^Fp       , Gll^Fp      , Gll^Fp      
Gll^Fp      , Rd          , Rd          , Rd          , Hh^Fp       , Hh^Fp       , Gg          , Gg^Efm      , Ww          , Ww          , Mm          , Hh          , Hh          , Hh          , Hh^Fp       , Hh          , Hh^Fmf      , Hh          , Hh          , Mm          , Mm          , Mm          , Hh          , Ww^Bw|      , Ww          , Hh          , Hh          , Hh          , Gg          , Gg          , Gg          , Hh          , Ww^Xo       , Gg^Xo       , Gg          , Gg          , Gg          , Gg          , Gg          , Rd          , Rd          , Hh^Fp       , Rd          , Hh^Fp       , Hh^Fp       , Hh          
Hh          , Gll^Fp      , Mm          , Mm          , Mm          , Hh^Fp       , Ww          , Ww          , Hh          , Mm          , Mm          , Mm          , Hh^Fp       , Hh^Fp       , Hh^Fp       , Hh          , Hh^Fmf      , Hh^Fmf      , Hh          , Hh          , Hh          , Mm          , Hh          , Rd          , Gg          , Ww          , Ww          , Ww          , Ww          , Ww          , Ww          , Hh          , Ww          , Ww^Xo       , Rd          , Gg          , Gg          , Gg          , Gg          , Gg          , Rd          , Rd          , Hh          , Rd          , Rd          , Hh          
Hh          , Hh^Fp       , Mm          , Mm          , Mm          , Gg          , Ww          , Hh^Fp       , Mm          , Mm          , Mm          , Mm          , Hh^Fp       , Hh          , Hh          , Hh          , Hh          , Hh^Fp       , Hh          , Hh^Fp       , Hh^Fp       , Hh          , Hh          , Rd          , Rd          , Gg          , Gg          , Ww          , Gg^Efm      , Gg^Efm      , Gg          , Ww          , Ww          , Gg          , Gg          , Rd          , Rd          , Gg          , Rd          , Rd          , Hh          , Hh^Fdf      , Hh^Fmf      , Hh          , Hh^Fp       , Rd          
Hh          , Hh          , Mm          , Mm          , Mm          , Mm          , Ww          , Gg          , Ce          , 4 Ke        , Hh^Fp       , Mm          , Mm          , Mm          , Mm          , Mm          , Hh^Fp       , Hh^Fp       , Hh^Fp       , Hh^Fp       , Gs^Fp       , Hh^Vhh      , Gg          , Gg^Vh       , Gg          , Rd          , Rd          , Gg          , Gg          , Gg^Vh       , Gg          , Ww          , Ww          , Gg          , Gg          , Gs^Fmf      , Gs^Fmf      , Rd          , Hh^Fdf      , Hh^Fp       , Hh^Fmf      , Hh^Fmf      , Hh          , Hh          , Hh^Fp       , Hh          
Hh          , Hh          , Mm          , Mm          , Hh          , Mm          , Ww          , Gg          , Ce          , Ce          , Hh^Fp       , Hh^Fmf      , Mm          , Hh^Fp       , Hh^Fp       , Mm          , Mm          , Hh^Fp       , Rd          , Hh          , Gs^Fp       , Gg          , Gg^Fet      , Gg^Efm      , Ww          , Gg          , Gg^Efm      , Rd          , Rd          , Gg          , Gg          , Ww          , Ww          , Gg          , Gg          , Gs^Fmf      , Rd          , Rd          , Hh          , Hh^Fp       , Hh          , Hh          , Hh^Fdf      , Hh          , Gll^Fp      , Hh          
Ww          , Hh          , Hh          , Hh          , Ww          , Ww          , Gg          , Gg          , Gg          , Gg          , Hh          , Hh^Fp       , Mm          , Hh          , Mm          , Mm          , Mm          , Hh^Fp       , Hh          , Rd          , Rd          , Rd          , Rd          , Gg          , Ww          , Ww          , Gg^Fet      , Rd          , Gs^Vh       , Rd          , Rd          , Rd          , Ww^Bw\      , Gg          , Rd          , Rd          , Rd          , Gg          , Hh          , Hh          , Hh^Fdf      , Hh          , Gll^Fp      , Gll^Fp      , Gll^Fp      , Gll^Fp      
Hh          , Ww          , Ww          , Ww          , Mm          , Gg          , Gg          , Gg          , Gg          , Hhd^Fmf     , Hh          , Hh^Fp       , Hh          , Mm          , Mm          , Mm          , Hh^Fp       , Hh^Fp       , Hh^Fmf      , Hh          , Hh^Fp       , Hh^Fp       , Rd          , Gs^Vh       , Gg          , Gg^Efm      , Rd          , Rd          , Gg^Efm      , Gg          , Ww          , Ww          , Ww          , Rd          , Gg          , Gg^Vh       , Rd          , Gg          , Gg          , Hh          , Hh^Fdf      , Hh^Fmf      , Gll^Fp      , Gll^Fp      , Gll^Fp      , Gll^Fp      
Gg          , Hh          , Hh^Fp       , Hh          , Mm          , Hh          , Hhd^Fmf     , Gg          , Gg          , Hh          , Hh          , Hh^Fp       , Hh          , Mm          , Mm          , Mm          , Hh          , Hh^Fp       , Hh          , Hh^Fp       , Hh^Fp       , Hh          , Gs^Fp       , Rd          , Rd          , Rd          , Gg          , Gg          , Ww          , Ww          , Ww          , Ww          , Ww          , Ww          , Ww          , Gg          , Rd          , Rd          , Rd          , Gg          , Hh^Fdf      , Gll^Fp      , Gll^Fp      , Gll^Fp      , Gll^Fp      , Gll^Fp      
Hh          , Hh^Fp       , Hh^Fp       , Mm          , Hh          , Hh          , Hh^Fp       , Gg          , Gll^Fp      , Gg          , Gg          , Hh          , Hh^Fp       , Hh          , Hh          , Hh^Fdf      , Hh^Fp       , Hh^Fp       , Hh          , Hh^Fp       , Hh          , Hh          , Hh^Fp       , Gs^Fp       , Gg          , Rd          , Gg^Efm      , Ww          , Ww          , Ww          , Ww          , Ww          , Gg^Efm      , Ww          , Ww          , Gg          , Rd          , Gg          , Gg          , Rd          , Rd          , Gll^Fp      , Gll^Fp      , Gll^Fp      , Rd          , Rd          
Hh          , Hh          , Hh^Fp       , Mm          , Mm          , Hh          , Hh^Fp       , Gll^Fp      , Hh^Fp       , Gll^Fp      , Gll^Fp      , Gg          , Gg          , Hh          , Gll^Fp      , Hh^Fp       , Hh^Fmf      , Hh          , Hh          , Hh^Fp       , Hh          , Hh^Fp       , Hh^Fdf      , Gs^Fp       , Gg          , Rd          , Gg          , Ww          , Gg^Efm      , Ww          , Ww          , Ce          , Ce          , Gg^Efm      , Gg          , Gg          , Rd          , Gg^Vh       , Gg          , Hh^Fmf      , Hh^Fmf      , Rd          , Rd          , Rd          , Gll^Fp      , Gll^Fp      
Hh          , Hh          , Hh          , Hh          , Mm          , Mm          , Mm          , Hh          , Hh          , Gll^Fp      , Gg          , Gg          , Gg          , Gg          , Gll^Fp      , Gll^Fp      , Hh          , Hh^Fp       , Hh          , Hh^Fp       , Hh          , Hh^Fp       , Hh          , Hh          , Gs^Fp       , Rd          , Gg          , Gg^Efm      , Ww          , Ww          , Ce          , Ce^Kov      , Gg          , Gg          , Rd          , Rd          , Gg          , Gg          , Gg          , Hh^Fmf      , Hh^Fmf      , Hh^Fdf      , Hh          , Gll^Fp      , Gll^Fp      , Gll^Fp      
Hh          , Hh          , Hh          , Hh          , Mm          , Hh          , Hh^Fdf      , Mm          , Hh          , Hh^Fp       , Gg          , Gg          , Hh^Fp       , Gll^Fp      , Gll^Fp      , Gll^Fp      , Gs^Fp       , Hh          , Gs^Fp       , Hh          , Hh^Fp       , Hh^Fmf      , Hh          , Hh          , Gg          , Rd          , Rd          , Gg          , Ww          , Gg          , Gg          , Gg          , Rd          , Rd          , Gg^Vh       , Gg          , Gg^Efm      , Gg          , Gg          , Hh^Fdf      , Hh          , Hh^Fmf      , Hh^Fmf      , Hh^Fmf      , Mm          , Mm          
Hh          , Hh          , Hh          , Hh          , Hh          , Mm          , Mm          , Hh          , Hh          , Hh          , Hh          , Hhd^Fmf     , Hh          , Hh          , Hh^Fp       , Hh          , Hh          , Gs^Fp       , Hh^Fmf      , Hh          , Hh^Fp       , Hh^Fp       , Hh          , Hh^Vhh      , Gg          , Gg          , Ww          , Ww^Bw\      , Rd          , Gg          , Rd          , Rd          , Gg          , Gg          , Gg          , Gg          , Gg          , Gg          , Hh          , Hh          , Hh          , Hh          , Mm          , Mm          , Mm          , Mm          
Hh          , Hh          , Hh          , Hh          , Hh          , Mm          , Mm          , Mm          , Hh          , Hh          , Hh          , Hh          , Hh^Fdf      , Hh          , Hh^Fp       , Hh^Fp       , Gg          , Gs^Fp       , Gs^Fp       , Hh          , Hh          , Hh          , Hh          , Hh          , Gg          , Gg          , Ww          , Gg          , Rd          , Rd          , Gg          , Gg          , Gg          , Gg          , Gg          , Gg          , Gg          , Gg          , Hh          , Hh^Fdf      , Hh          , Hh^Fp       , Hh^Fp       , Mm          , Mm          , Mm          
Hh          , Hh          , Mm          , Mm          , Mm          , Mm          , Mm          , Mm          , Gll^Fp      , Gll^Fp      , Hh          , Hh^Fp       , Hh          , Hh^Fp       , Hh^Fp       , Hh^Vhh      , Gg          , Gg          , Gg^Vh       , Gg          , Gg^Efm      , Hh          , Gg          , Gg          , Ww          , Ww          , Gg          , Gg          , Rd          , 1 Gg        , Gg          , Gg          , Gg          , Gg          , Gg          , Gg          , Hh          , Hh          , Hh^Fmf      , Hh^Fmf      , Hh          , Hh^Fmf      , Hh^Fp       , Hh          , Hh          , Hh          
Hh          , Mm          , Mm          , Mm          , Mm          , Hh          , Hh^Fmf      , Gll^Fp      , Gll^Fp      , Gll^Fp      , Rd          , Hh^Fp       , Hh^Fp       , Hh^Fmf      , Hh          , Gs^Fp       , Gg          , Gg          , Gg^Efm      , Gg^Efm      , Gg^Efm      , Gg          , Ww          , Ww          , Ww          , Gg          , Rd          , Rd          , Gg          , Gg          , Gg          , Gg          , Hh^Vhh      , Hh          , Hh^Fdf      , Hh          , Hh^Fdf      , Hh          , Hh          , Hh          , Hh          , Hh^Fmf      , Ww          , Hh^Fp       , Hh^Fp       , Hh          
Gg          , Mm          , Hh          , Mm          , Hh          , Hh          , Hh          , Gll^Fp      , Gll^Fp      , Gll^Fp      , Gll^Fp      , Rd          , Rd          , Rd          , Rd          , Gs^Fp       , Gg          , Gg^Efm      , Ww          , Ww          , Ww          , Ww          , Ww          , Ww          , Rd          , Ww^Bw/      , Ww          , Ww          , Ww          , Gg          , Ww          , Hh          , Hh          , Hh          , Ww          , Hh          , Ww          , Ww          , Ww          , Ww^Es       , Ww^Es       , Ww          , Mm          , Ww          , Ww          , Hh          
Gg          , Mm          , Mm          , Mm          , Mm          , Hh          , Mm          , Hh          , Gll^Fp      , Gll^Fp      , Hh          , Hh^Fp       , Gs^Fp       , Rd          , Gg          , Rd          , Rd          , Ww          , Ww          , Ww          , Gg^Efm      , Ww          , Gg          , Gg          , Rd          , Gg          , Hh          , Hh          , Hh          , Ww          , Hh          , Ww          , Ww          , Hh^Fdf      , Ww          , Ww          , Hh          , Hh          , Hh^Fdf      , Hh          , Mm          , Mm          , Mm          , Mm          , Mm          , Ww          
Mm          , Mm          , Mm          , Mm          , Mm          , Mm          , Mm          , Mm          , Mm          , Hh          , Hh^Fp       , Hh^Fp       , Gs^Fp       , Gs^Fp       , Gg          , Gg          , Ww          , Ww^Bw\      , Rd          , Gg          , Gg          , Gg          , Rd          , Rd          , Hh          , Hh          , Hh^Fmf      , Hh^Fmf      , Hh          , Hh          , Hh          , Hh          , Hh^Fmf      , Ww          , Hh^Fmf      , Hh^Fmf      , Hh          , Hh          , Hh          , Hh          , Hh^Fdf      , Mm          , Mm          , Mm          , Hh          , Hh          
Mm          , Mm          , Mm          , Mm          , Mm          , Mm          , Ww^Es       , Ww^Es       , Ww^Es       , Ww^Es       , Ww^Es       , Gs^Fp       , Ww          , Ww          , Ww          , Ww          , Gg          , Gg^Efm      , Gg          , Rd          , Rd          , Rd          , Gg          , Gg          , Hh^Vhh      , Hh^Fdf      , Hh          , Hh^Fmf      , Hh^Fmf      , Hh          , Hh^Fmf      , Hh^Fmf      , Hh^Fdf      , Hh          , Gll^Fp      , Hh^Fmf      , Hh          , Hh          , Mm          , Mm          , Mm          , Mm          , Hh          , Mm          , Hh          , Gg          
Mm          , Mm          , Ww          , Mm          , Ww          , Ww          , Hh          , Ww^Es       , Gll^Fp      , Gs^Fp       , Gs^Fp       , Ww          , Gg^Efm      , Gg^Efm      , Gg^Efm      , Gg          , Gg^Vh       , Gg^Efm      , Rd          , Rd          , Gs^Fp       , Rd          , Rd          , Gg          , Hh          , Hh^Fdf      , Hh          , Hh          , Hh          , Hh          , Gll^Fp      , Gll^Fp      , Gll^Fp      , Gll^Fp      , Gll^Fp      , Hh^Fmf      , Hh          , Hh^Fdf      , Mm          , Hh          , Mm          , Hh          , Hh          , Hh          , Hh          , Hh          
Ww          , Ww          , Ww^Es       , Ww          , Hh^Fp       , Hh          , Gll^Fp      , Gll^Fp      , Gll^Fp      , Gll^Fp      , Hh^Fp       , Gs^Fp       , Hh^Fp       , Gg^Vh       , Gg          , Gg          , Gg          , Rd          , Gs^Fp       , Gs^Fp       , Hh^Fp       , Hh^Fp       , Hh          , Rd          , Rd          , Hh          , Rd          , Hh          , Rd          , Gll^Fp      , Rd          , Rd          , Rd          , Rd          , Rd          , Gll^Fp      , Gll^Fp      , Hh          , Mm          , Mm          , Mm          , Hh^Fmf      , Hh          , Hh          , Hh          , Hh          
Hh          , Mm          , Mm          , Hh          , Hh          , Gll^Fp      , Gll^Fp      , Gll^Fp      , Gll^Fp      , Gll^Fp      , Gll^Fp      , Hh^Fp       , Rd          , Hh^Fp       , Mm          , Gg          , Rd          , Rd          , Gs^Fp       , Hh^Fp       , Hh^Fp       , Hh^Fdf      , Hh^Fdf      , Hh^Fdf      , Hh          , Rd          , Hhd^Fdf     , Rd          , Hhd^Fmf     , Rd          , Gll^Fp      , Gll^Fp      , Gll^Fp      , Gll^Fp      , Rd          , Gll^Fp      , Gll^Fp      , Gll^Fp      , Mm          , Mm          , Hh^Fmf      , Hh          , Hh^Fp       , Hh^Fp       , Hh          , Hh          
Hh          , Mm          , Mm          , Mm          , Mm          , Hh          , Gll^Fp      , Gll^Fp      , Gll^Fp      , Rd          , Rd          , Rd          , Mm          , Rd          , Rd          , Rd          , Hh^Fp       , Rd          , Rd          , Hh^Fmf      , Gll^Fp      , Hh          , Hh          , Hh          , Hh          , Hhd^Fdf     , Hhd^Fmf     , Hhd^Fmf     , Hh^Fp       , Hh^Fp       , Gll^Fp      , Gll^Fp      , Gll^Fp      , Gll^Fp      , Gll^Fp      , Rd          , Rd          , Gll^Fp      , Gll^Fp      , Mm          , Hh          , Hh          , Hh^Fp       , Hh^Fp       , Hh          , Hh          
Hh          , Mm          , Mm          , Mm          , Hh          , Mm          , Gll^Fp      , Gll^Fp      , Gll^Fp      , Gll^Fp      , Hh^Fp       , Gll^Fp      , Mm          , Mm          , Mm          , Mm          , Mm          , Hh          , Hh^Fp       , Gll^Fp      , Gll^Fp      , Hh          , Hh^Fp       , Hh          , Hh^Fdf      , Mm          , Hh          , Hh          , Hh          , Hh          , Hh          , Hh^Fp       , Gll^Fp      , Gll^Fp      , Gll^Fp      , Gll^Fp      , Rd          , Gll^Fp      , Gll^Fp      , Hh          , Hh          , Hh          , Hh          , Hh          , Hh          , Hh          
Mm          , Mm          , Mm          , Mm          , Hh          , Hh^Fp       , Hh          , Hh          , Hh          , Gll^Fp      , Hh          , Hh          , Hh          , Hh          , Hh          , Hh          , Hh          , Hh^Fp       , Hh          , Hh^Fp       , Hh          , Hh^Fp       , Hh          , Hh          , Hh          , Hh          , Hh          , Hh          , Hh          , Hh          , Hh          , Hh          , Hh          , Gll^Fp      , Gll^Fp      , Gll^Fp      , Rd          , Gll^Fp      , Gll^Fp      , Hh          , Hh          , Hh          , Hh          , Hh          , Hh          , Hh          
