border_size=1
usage=map

Gll^Fp      , Gll^Fp      , Wo          , Gll^Fp      , Gll^Fp      , Gll^Fp      , Gll^Fp      , Gll^Fp      , Hh^Fp       , Gg          , Hh^Fp       , Hh^Fp       , Gll^Fp      , Gg          , Hh^Fp       , Gg          , Gll^Fp      , Gll^Fp      , Gll^Fp      , Ww          , Ww          , Ha^Fpa      , Ms          , Ms          , Ms          , Ms          
Gll^Fp      , Gll^Fp      , Wo          , Gll^Fp      , Gll^Fp      , Gll^Fp      , Gll^Fp      , Gll^Fp      , Gll^Fp      , Hh^Fp       , Hh          , Hh^Fp       , Gll^Fp      , Hh          , Hh^Fp       , Gll^Fp      , Gll^Fp      , Gll^Fp      , Ww          , Ww          , Gll^Fp      , Ha^Fpa      , Ha^Fpa      , Ha          , Ms          , Ms          
Gll^Fp      , Gll^Fp      , Wo          , Gll^Fp      , Gll^Fp      , Gll^Fp      , Gll^Fp      , Gll^Fp      , Gd^Vo       , Gg          , Gg          , Hh^Fp       , Hh          , Hh^Fp       , Mm          , Ms          , Md          , Gll^Fp      , Ww          , Gll^Fp      , Hh^Fp       , Hh^Fp       , Md          , Ms          , Ha^Fpa      , Ms          
Gll^Fp      , Gll^Fp      , Wo          , Gs          , Gd          , Gd          , Gd^Vo       , Gs          , Gd          , Gs          , Gd^Vo       , Gg          , Hh          , Mm          , Mm          , Mm          , Md          , Gll^Fp      , Ww          , Hh^Fp       , Md          , Mm          , Mm          , Mm          , Ha^Fpa      , Ha^Fpa      
Gg          , Gs          , Wo          , Gs          , Gd^Vo       , Gs          , Gd          , Gd          , Gs          , Gd          , Gd          , Gg          , Co          , Co          , Md          , Md          , Ww          , Ww          , Gs          , Gs          , Md          , Mm          , Mm          , Mm          , Ms          , Ms          
Wo          , Wo          , Gs          , Gg          , Gd          , Gs          , Gd          , Gs          , Gd          , Gs          , Gd          , Gd          , Co          , 2 Ko        , Mm^Xm       , Mm^Xm       , Ww          , Gs          , Gs          , Gs          , Chr         , Mm          , Rr          , Mm          , Mm          , Mm          
Gg          , Gg          , Gg          , Gg          , Gs          , Gs          , Gd^Vo       , Gd          , Gs          , Gd^Vo       , Hh^Fp       , Hh^Fp       , Co          , Co          , Co          , Mm          , Mm          , Ww          , Ww          , Wo^Es       , Chr         , Chr         , Mm          , Mm          , Mm          , Mm          
Gg          , Gg          , Gg          , Gg          , Gg          , Gs          , Gg          , Gd          , Hh^Fp       , Hh^Fp       , Mm          , Hh^Fp       , Hh^Fp       , Co          , Gs          , Hh^Fp       , Hh^Fp       , Hh^Fp       , Ww          , Wo          , Gg          , Chr         , Mm          , Mm          , Mm          , Mm          
Ww          , Gll^Fp      , Gg          , Gg          , Gg          , Gg          , Gll^Fp      , Hh^Fp       , Hh^Fp       , Mm          , Mm          , Hh^Fp       , Hh^Fp       , Hh^Fp       , Gs          , Gs          , Gd          , Gs          , Wo          , Ww          , Ww^Bw/      , Ch          , Gg          , Hh^Fp       , Hh^Fp       , Hh          
Gll^Fp      , Ww          , Ww          , Gg          , Gg          , Gg          , Gg          , Gll^Fp      , Hh^Fp       , Hh^Fp       , Hh^Fp       , Hh^Fp       , Gll^Fp      , Gs          , Gg          , Gd          , Gg          , Gg          , Gd          , Wo^Bw/      , Wo          , Wo          , Gs          , Gg          , Hh^Fp       , Hh^Fp       
Gll^Fp      , Gll^Fp      , Ww          , Ww          , Gll^Fp      , Gll^Fp      , Gll^Fp      , Gg          , Gg          , Gll^Fp      , Hh^Fp       , Hh^Fp       , Gll^Fp      , Gg          , Gg          , Gg          , Gd          , Gd          , Gg          , Gg          , Gg          , Wo          , Gd          , Gs          , Hh^Fp       , Hh^Fp       
Ww          , Gll^Fp      , Ww          , Gll^Fp      , Gll^Fp      , Gll^Fp      , Gg          , Gg          , Gg          , Gs          , Hh^Fp       , Hh^Fp       , Gll^Fp      , Gs          , Gs          , Gs          , Gd          , Gg          , Gs          , Gg          , Gg          , Wo          , Gg          , Hh^Fp       , Gs          , Gs          
Ww          , Ww          , Ww^Es       , Ww          , Ww          , Gll^Fp      , Gs          , Gg          , Gg          , Gs          , Gll^Fp      , Gll^Fp      , Gll^Fp      , Gg          , Gg          , Gd          , Gd          , Gs          , Gs          , Gg          , Hh^Fp       , Wo          , Wo^Es       , Gs          , Gd          , Gs          
Ww          , Ww          , Ww          , Ww          , Ww          , Ww          , Gs          , Gg          , Gg          , Gg          , Gg          , Gll^Fp      , Gg          , Gg          , Gd^Vhr      , Gg          , Gd          , Gg          , Hh          , Hh^Fp       , Hh^Fp       , Wo          , Wo          , Gg          , Hh^Fp       , Hh          
Ww          , Ww          , Gs^Fms      , Ww          , Ww          , Ww          , Ww          , Gg          , Gg          , Gg          , Gg          , Gs          , Gg          , Gg          , Gg          , Gg          , Gd          , Gg          , Hh^Fp       , Md          , Md          , Wo          , Gg          , Hh          , Hh^Fp       , Hh^Fp       
Ww          , Gs^Fms      , Gs          , Ww^Es       , Ww          , Ww          , Ww          , Gs          , Gd^Vhr      , Gg          , Gd          , Gs          , Gg          , Gg          , Gg          , Gd          , Gd          , Gg          , Gg          , Hh          , Gg          , Wo          , Wo          , Hh^Fp       , Mm          , Mm          
Ww          , Ww^Es       , Ww^Es       , Gs^Fms      , Ww          , Ww          , Ww          , Gg          , Gg          , Gg          , Gg          , Gg          , Gg          , Gg          , Gg          , Gd          , Gg          , Gg          , Gg          , Gd^Vhr      , Gg          , Gg          , Wo          , Wo^Es       , Mm          , Mm          
Ww          , Ww          , Ww          , Ww          , Ww          , Ww          , Gg          , Gg          , Gg          , Gs^Fms      , Gll^Fp      , Gg          , Gg          , Gg          , Gd          , Gd          , Gs          , Gs          , Gs          , Gg          , Gs          , Gg          , Gs          , Wo          , Hh^Fp       , Mm          
Gs^Fds      , Ww          , Gs          , Ww          , Gll^Fp      , Gg          , Gd^Vhr      , Gg          , Gg          , Gll^Fp      , Gs          , Gg          , Gd          , Gd          , Gs          , Gs          , Gg          , Hh^Fp       , Hh^Fp       , Gg          , Gs          , Gs          , Gs          , Wo          , Hh          , Mm          
Gs^Fds      , Gs          , Ww          , Ww          , Gs^Fms      , Gg          , Gg          , Gd          , Gg          , Gll^Fp      , Gs          , Gd          , Gs          , Gs          , Gg          , Gg          , Hh^Fp       , Gs^Fms      , Mm          , Hh^Fp       , Gg          , Gs          , Gg          , Wo          , Wo          , Hh          
Ww          , Ww          , Gg          , Gg          , Gg          , Gg          , Gg          , Gg          , Gs          , Gs          , Gd          , Gd          , Gll^Fp      , Gg          , Gg          , Hh^Fp       , Mm          , Hh^Fp       , Mm          , Hh          , Gs          , Gd^Vhr      , Gg          , Gs          , Wo          , Hh          
Gg          , Gg          , Gg          , Gg          , Gg          , Gs          , Gs          , Gs          , Gs          , Gs          , Gd          , Gs          , Gll^Fp      , Gs^Fms      , Gs^Fms      , Gs^Fms      , Gs^Fms      , Hh          , Hh^Fp       , Hh^Fp       , Gg          , Gs          , Gs          , Gg          , Gs          , Wo          
Gs^Fms      , Gg          , Gg          , Ce          , 1 Ke        , Gg          , Gg          , Gs          , Gd          , Gd          , Gs^Fms      , Gs          , Gs^Fms      , Gll^Fp      , Gg          , Gg          , Gg          , Gs          , Gs          , Gs          , Gg          , Gg          , Gd          , Gs          , Gs          , Gs          
Gs^Fms      , Gg          , Gg          , Gg          , Gg          , Ce          , Gd          , Gs          , Gd          , Gs^Fms      , Gs^Fms      , Gs^Fms      , Gg          , Gg          , Gg          , Gg          , Gg          , Gg          , Gg          , Gs          , Gg          , Gg          , Gg          , Gg          , Gg          , Gg          
Gs^Fms      , Gll^Fp      , Gs^Fms      , Gg          , Gg          , Gg          , Gd          , Gd          , Gg          , Gg          , Gg          , Gs^Fms      , Gs^Fms      , Gll^Fp      , Gg          , Gg          , Gg          , Gg          , Gg          , Gg          , Gg          , Gg          , Gg          , Gg          , Gg          , Gg          
