border_size=1
usage=map

Uu          , Uu          , Xu          , Xu          , Qxu         , Qxu         , Qxu         , Uu          , Uu          , Xu          , Xu          , Uu          , Uu          , Xu          , Xu          , Qxu         , Uu          , Xu          , Qxu         , Qxu         , Xu          , Xu          , Ww          
Xu          , Uu          , Xu          , Xu          , Xu          , Qxu         , Qxu         , Qxu         , Uu          , Qxu         , Qxu         , Qxu         , Uu          , Uu          , Xu          , Xu          , Uu          , Xu          , Qxu         , Xu          , Ww          , Ww          , Xu          
Xu          , Xu          , Uu          , Xu          , Xu          , Qxu         , Qxu         , Uu          , Uu          , Xu          , Xu          , Qxu         , Uu          , Uu          , Uu          , Uu          , Qxu         , Qxu         , Uu          , Uu          , Ww          , Xu          , Xu          
Uu          , Uu          , Uu          , Uu          , Uu          , Uu          , Uu          , Uu          , Uu          , Xu          , Xu          , Qxu         , Uu          , Uu          , Uu          , Qxu         , Uu          , Qxu         , Qxu         , Ww^Es       , Ww          , Uu          , Uu          
Uu          , Xu          , Xu          , Uu          , Xu          , Uu          , Uu          , Uu          , Uu          , Xu          , Uu          , Uu          , Uu          , Uu          , Uu          , Qxu         , Uu          , Qxu         , Uu          , Uu          , Ww          , Xu          , Xu          
Qxu         , Xu          , Xu          , Xu          , Xu          , Xu          , Xu          , Uu          , Uu          , Uu          , Xu          , Xu          , Xu          , Xu          , Uu          , Uu          , Uu          , Qxu         , Ww^Es       , Ww          , Ww          , Uu          , Uu          
Qxu         , Uu          , Uu          , Uu          , Uu          , Xu          , Xu          , Uu          , Uu          , Xu          , Uu          , Xu          , Xu          , Xu          , Xu          , Uu          , Uu          , Qxu         , Qxu         , Ww          , Ww          , Ur          , Ur          
Uu          , Uu          , Xu          , Uu          , Uu          , Xu          , Uu          , Uu          , Uu          , Uu          , Uu          , Uu          , Uu          , Uu          , Uu          , Uu          , Uu          , Qxu         , Qxu         , Qxu         , Qxu         , Qxu         , Ur          
Uu          , Xu          , Xu          , Xu          , Xu          , Uu          , Uu          , Uu          , Uu          , Uu          , Qxu         , Uu          , Uu          , Uu          , Uu          , Uu          , Uu          , Qxu         , Ur          , Uu^Vu       , Ur          , Ur          , Xu          
Uu          , Xu          , Uu          , Uu          , Uu          , Uu          , Uu          , Uu          , Uu          , Uu          , Qxu         , Qxu         , Uu          , Uu          , Uu          , Uu          , Uu          , 3 Kud       , Ur          , Ur          , Ur          , Uu^Vu       , Uu          
Xu          , Uu          , Qxu         , Uu          , Qxu         , Uu          , Qxu         , Uu          , Uu          , Qxu         , Xu          , Xu          , Uu          , Uu          , Uh          , Uh          , Uu          , Cud         , Cud         , Ur          , Qxu         , Uu^Vu       , Qxu         
Uu          , Xu          , Xu          , Qxu         , Qxu         , Qxu         , Qxu         , Qxu         , Uu          , Uu          , Uu          , Uu          , Uu          , Uu          , Uh          , Uh          , Uu          , Uu          , Uu          , Qxu         , Qxu         , Qxu         , Uu          
Uu          , Xu          , Uu          , Qxu         , Xu          , Xu          , Uu          , Qxu         , Qxu         , Uu          , Uu          , Uu          , Uu          , Uu          , Xu          , Uh          , Uh          , Uh          , Uh          , Uu          , Uu          , Uu          , Uu          
Uu          , Uu          , Uu          , Uu          , Uu          , Uu          , Qxu         , Uu          , Uu          , Uu          , Uu          , Uu          , Uu          , Xu          , Uu          , Uu          , Uu          , Xu          , Uh          , Uh          , Uu          , Uu^Vu       , Uu          
Xu          , Uu          , Qxu         , Uu          , Qxu         , Uu          , Qxu         , Uu          , Uu          , Uu          , Uu          , Uu          , Uu          , Uu          , Uh          , Uh          , Uu          , Xu          , Uu          , Uu          , Uu          , Uu          , Uh          
Uu          , Xu          , Xu          , Qxu         , Xu          , Qxu         , Qxu         , Qxu         , Uu          , Uu          , Uu          , Uu          , Uu          , Uu          , Uh          , Uh          , Uu          , Uu          , Uu          , Xu          , Qxu         , Qxu         , Uu          
Uu          , Xu          , Uu          , Xu          , Xu          , Qxu         , Uu          , Qxu         , Qxu         , Uu          , Uu          , Uu          , Uu          , Uu          , Uu          , Uh          , Uh          , Uh          , Uh          , Uu          , Uu          , Uu          , Uu          
Uu          , Uu          , Uu          , Uu          , Uu          , Uu          , Uu          , Uu          , Uu          , Uu          , Uu          , Uu          , Xu          , Uu          , Uu          , Uu          , Xu          , Xu          , Uh          , Uh          , Uu          , Uu          , Uu          
Uu          , Uu          , Qxu         , Qxu         , Qxu         , Uu          , Uu          , Uu          , Qxu         , Uu          , Uu          , Xu          , Xu          , Uu          , Uu          , Xu          , Uu          , Xu          , Uu          , Uu          , Uu          , Uu          , Uh          
Uu          , Qxu         , Uh          , Uh          , Uu          , Uh          , Uu          , Qxu         , Uu          , Uu          , Uu          , Uu          , Xu          , Xu          , Uu          , Uu          , Uu          , Uu          , Xu          , Xu          , Xu          , Uu          , Uu          
Uu          , Qxu         , 2 Kud       , Uu          , Uu          , Qxu         , Uu          , Uu          , Xu          , Uu          , Uu          , Uu          , Uu          , Uu          , Uu          , Uu          , Uu          , Uu          , Xu          , Xu          , Uu          , Uu          , Xu          
Ww^Es       , Cud         , Uu^Vu       , Cud         , Uu          , Xu          , Xu          , Xu          , Xu          , Uu          , Uu          , Uu          , Uu^Ii       , Uu          , Uu          , Uu          , Uu          , Uu          , Uu          , Uu          , Uu          , Uu          , Xu          
Uu          , Uu          , Uu          , Uu          , Uu^Vu       , Uu          , Xu          , Xu          , Uu          , Uu          , Uu          , Uu          , Uu          , Uu          , Uu          , Uu          , Uu          , Uu          , Uu          , Uu          , Ww          , Uu          , Ww          
Uu          , Uu          , Uu^Vu       , Uu          , Ww          , Uu          , Xu          , Uu          , Uu^Vu       , Uu          , Uu          , Uu          , Uu          , Uu          , Uu          , Uu          , Ww^Es       , Ww          , Ww^Es       , Ww^Es       , Ww^Es       , Ww          , Uu          
Uu          , Uu          , Ww^Es       , Ww          , Xu          , Ww          , Ww^Es       , Xu          , Uu          , Uu          , Ww^Es       , Uu          , Uu          , Uu          , Ww          , Ww          , Uu          , Ww          , Ur          , Uu          , Uu          , Uu          , Uu          
Ww          , Ww^Es       , Uu^Vu       , Uh          , Uh          , Uu          , Uu          , Ww          , Ww          , Ww          , Ww          , Ww          , Ww          , Ww^Es       , Xu          , Uu          , Uu          , Uu          , Ur          , Uu          , Uu          , Uu          , Uu          
Qxu         , Uu          , Uu          , Uu          , Uu          , Uu          , Uu          , Qxu         , Uu^Ii       , Uu^Uf       , Ww          , Uu          , Uu          , Uu          , Uu          , Ur          , Uu          , Xu          , Xu          , Uu          , Uu          , Uu          , Uu          
Qxu         , Qxu         , Qxu         , Uu          , Uu          , Uu          , Uu          , Uu^Uf       , Uu          , Uu^Uf       , Ww^Ii       , Uu^Ii       , Uu          , Uu          , Uu          , Ur          , Uu          , Uu          , Xu          , Xu          , Uu          , Uu          , Xu          
Qxu         , Qxu         , Uu          , Qxu         , Uu          , Uu          , Uu          , Uu          , Uu^Uf       , Uu^Ii       , Ww          , Uu          , Uu          , Uu          , Uu          , Ur          , Uu          , Uu          , Uu          , Uu          , Xu          , Xu          , Uu          
Uu          , Uu          , Uu          , Uu          , Uu          , Uu          , Uu          , Uu^Ii       , Uu          , Uu          , Ww^Es       , Uu          , Uu          , Uu          , Uu          , Ur          , Uu          , Uu          , Uu          , Xu          , Uu          , Uu          , Uu          
Uu          , Uu          , Uu          , Uu          , Uu          , Uu          , Uu          , Uu          , Uu          , Uu          , Uu          , Ww          , Ww^Es       , Uu          , Uu          , Ur          , Uu          , Uu          , Uu          , Uu          , Uu          , Uu          , Uu          
Xu          , Uu          , Uu          , Uu          , Uu          , Uu          , Xu          , Uu          , Uu          , Uu          , Uu          , Uu          , Ww          , Uu          , Uu          , Ur          , Uu          , Uu          , Uu          , Uu          , Uu          , Uu          , Uu          
Xu          , Xu          , Xu          , Uh          , Uh          , Xu          , Xu          , Xu          , Uu          , Uu          , Uu          , Uu          , Ww^Es       , Uu          , Uu          , Ur          , Uu          , Uu          , Uu          , Uu          , Uu          , Uu          , Uu          
Xu          , Xu          , Xu          , Uh          , Uh          , Uh          , Xu          , Uu          , Xu          , Uu          , Ww^Es       , Ww          , Uu          , Uu          , Uu          , Ur          , Uu          , Uu          , Uu          , Uu          , Uu          , Uu          , Uu          
Uh          , Xu          , Xu          , Xu          , Uh          , Xu          , Xu          , Uh          , Xu          , Ww^Es       , Ww^Es       , Ww          , Uu          , Uu          , Uu          , Ur          , Uu          , Uu          , Uu          , Uu          , Uu          , Uu          , Uu          
Uh          , Uh          , Uh^Dr       , Uh^Dr       , Uu^Dr       , Uh          , Uu^Dr       , Uh          , Xu          , Ww          , Uu          , Uu          , Uu          , Uh          , Uh          , Ur          , Uu          , Uu          , Uu          , Uu          , Uu          , Uu          , Uu          
Uh          , Uh^Dr       , Uh^Dr       , Uu^Es       , Ur^Es       , Uu^Dr       , Uu          , Uh^Es       , Uh^Es       , Ww          , Uu          , Uu          , Uu          , Uh          , Uh          , Ur          , Uu          , Uu          , Uh          , Uu          , Uu          , Uu          , Uu          
Uh          , Uh          , Uh^Dr       , Uu^Dr       , Uu^Vud      , Ur^Br\      , Ur^Br\      , Uu          , Uh          , Ww^Es       , Ww^Es       , Uu          , Uu          , Uu          , Ur          , Ur          , Uu          , Uu          , Uh          , Uh          , Uu          , Uu          , Uu          
Uu          , Uh          , Uu          , Uh^Dr       , Uh^Dr       , Uu          , Ur          , Ur^Br\      , Ur^Br\      , Uu          , Ww          , Cud         , Cud         , Uu          , Ur          , Xu          , Xu          , Xu          , Xu          , Uu          , Uu          , Uu          , Uu          
Uu          , Uu          , Uu          , Uu          , Uu          , Uu          , Ur          , Uu^Ii       , Ww^Ii       , Ww^Br\      , Ur^Br\      , Uu          , Uu          , Uu          , Ur          , Uu          , Uu          , Xu          , Xu          , Uh          , Uu          , Uu          , Uu          
Uu          , Uu          , Uu          , Uu          , Uu          , Uu          , Ur          , Uu          , Ww^Es       , Uu          , Uu          , Ur^Br\      , Uu          , Uu          , Ur          , Uu          , Xu          , Xu          , Uu          , Xu          , Xu          , Uu          , Uu          
Uu          , Uh          , Uh          , Uh          , Uh          , Uu          , Uu          , Ur          , Wwf^Es      , Uu          , Uu          , Ur^Br|      , Uu          , Uu          , Ur          , Uu          , Uu          , Uu          , Uu          , Uu          , Uu          , Uu          , Uu          
Uh          , Uh          , Uh          , Uh          , Uu          , Uu          , Uu          , Uu          , Ww^Es       , Ur          , Ur          , Ur^Br|      , Uu          , Uu          , Ur          , Uu          , Uu          , Uu          , Uu          , Qxu         , Uu          , Uu          , Uu          
Uu          , Uh          , Ww^Es       , Uh          , Uh          , Uh          , Ww          , Ww^Es       , Qxu         , Uu          , Uu          , Ur^Br|      , Ur          , Uu          , Ur          , Uu          , Qxu         , Qxu         , Qxu         , Qxu         , Uu          , Uu          , Xu          
Ww^Es       , Ww          , Uu^Uf       , Ww^Es       , Ww          , Ww          , Uu          , Qxu         , Qxu         , Uu          , Uu          , Ur^Br|      , Uu          , Ur          , Uu          , Uu          , Qxu         , Qxu         , Qxu         , Uu          , Uu          , Xu          , Xu          
Rb^Em       , Rb^Em       , Rb^Em       , Uu^Uf       , Rb^Ii       , Uu^Uf       , Uu          , Qxu         , Qxu         , Qxu         , Uu          , Ur^Br|      , Uu          , Ur          , Uu          , Uu          , Uu          , Qxu         , Qxu         , Uu          , Xu          , Xu          , Xu          
Uu          , Uu^Uf       , Rb^Em       , Uu^Ufi      , Rb^Em       , Rb^Em       , Ur          , Uu          , Qxu         , Qxu         , Uu          , Ur^Br|      , Uu          , Ur          , Qxu         , Uu          , Uu          , Qxu         , Qxu         , Uu          , Uu          , Xu          , Xu          
Uu          , Rb^Em       , Rb^Ii       , Rb^Ii       , Uu          , Rb^Em       , Uu          , Ur          , Ur          , Uu          , Uu          , Ur^Br|      , Uu          , Ur          , Qxu         , Qxu         , Qxu         , Uu          , Qxu         , Uu          , Uu          , Uu          , Uu          
Uu          , Uu          , Uu          , Uu          , Uu          , Uu          , Uu          , Uu          , Uu          , Ur          , Ur          , Ur^Br|      , Ur          , Ur          , Uu          , Qxu         , Qxu         , Uu          , Uu          , Qxu         , Uu          , Uu          , Uu          
Uu          , Uu^Vud      , Ur          , Uu^Vud      , Ur          , Uu          , Uu          , Uu          , Uu          , Uu          , Ur          , Ur^Br|      , Uu          , Uu          , Uu          , Uu          , Uu          , Uu          , Uu          , Uu          , Uu          , Uu          , Uu          
Uu          , Uu          , Ur          , Ur          , Uu          , Ur          , Ur          , Uu          , Uu          , Uu          , Ur          , Ur^Br|      , Uu          , Uu          , Uu          , Uu          , Uu          , Uu          , Uu          , Uu          , Uu          , Uu          , Uu          
Uu          , Uu          , Uu^Vud      , Uu          , Qxu         , Uu          , Uu          , Ur          , Ur          , Ur          , Uu          , Ur^Br|      , Uu          , Uu          , Uu          , Uu          , Uu          , Uu          , Qxu         , Qxu         , Qxu         , Uu          , Uu          
Uu          , Uu          , Uu          , Uh^Ii       , Qxu         , Qxu         , Ur          , Ur          , Ur          , Ur          , Ur^Br/      , Ur^Br|      , Uu          , Uu          , Uu          , Uu          , Uu          , Uu          , Ur          , Qxu         , Qxu         , Uu          , Uu          
Uu          , Uu          , Qxu         , Qxu         , Qxu         , Cud         , Ur          , Uu          , Xuc         , Ur^Br/      , Uu          , Uu^Ii       , Uu          , Uu          , Uu          , Uu          , Uu          , Uu          , Uu          , Uu          , Uu          , Uu          , Uu          
Qxu         , Qxu         , Qxu         , Qxu         , Ur          , Ur          , Ur          , Cud         , Cud         , Xuc         , Xuc         , Xu          , Xu          , Xu          , Xu          , Uu          , Uu          , Uu          , Uu          , Uu          , Uu          , Uu          , Uu          
Xu          , Qxu         , Ur          , Ur          , Uu^Vud      , Ur          , Ur          , Cud         , Cud         , Kud         , Ur^Ii       , Xuc         , Xuc         , Xu          , Uu          , Uu          , Qxu         , Uu          , Uu          , Uu          , Uu          , Uu          , Ww          
Xuc         , Xuc         , Uu^Vud      , Ur          , Ur          , Ur          , Ur          , Ur          , Ur          , Ur          , Uu^Vud      , Ur          , Ur          , Xuc         , Xuc         , Qxu         , Qxu         , Ww          , Ww^Es       , Uu          , Ww          , Ww          , Ww          
Xu          , Ur          , Ur          , Ur          , Cud         , Cud         , Ur          , Ur          , Ur          , Ur          , Ur          , Ur          , Ur          , Ur          , Ur          , Cud         , Qxu^Bs\     , Qxu         , Uu          , Ww          , Ww          , Ww^Es       , Uu          
Gs          , Xu          , Xu          , Cud         , Rr          , Rr          , Cud         , 1 Ur        , Ur          , Ur          , Ur          , Uu^Vud      , Ur          , Ur          , Ur          , Qxu         , Qxu         , Ur          , Ur          , Ww^Es       , Uu          , Uu          , Uu          
Gs          , Gd          , Rp          , Rr          , Xu          , Cud         , Kud         , Cud         , Ur          , Ur          , Ur          , Ur          , Uu^Vud      , Ur          , Qxu         , Qxu         , Uu          , Uu          , Uu          , Uu          , Uu          , Uu          , Uu          
Re          , Rp          , Gd          , Gs          , Xu          , Xu          , Xu          , Ur          , Urb         , Ur          , Ur          , Ur          , Ur          , Ur          , Xuc         , Xu          , Xu          , Uu          , Uu          , Uu          , Uu          , Uu          , Uu          
