border_size=1
usage=map

Uu          , Uu          , Uu          , Uu          , Uu          , Uu          , Uu          , Uu          , Uu          , Uu          , Uu          , Uu          , Uu          , Uu          , Uu          , Uu          , Uu          , Uu          , Uu          , Uu          , Uu          , Uu          , Uu          , Uu          , Uu          , Uu          , Uu          , Uu          , Xu          , Xu          , Uu          , Uu          , Uu^Ii       , Uu          , Uu          , Uu          , Uu          , Uu          , Uu          , Uu          , Xu          , Xu          , Xu          , Uu          , Xu          , Qxu         , Xu          , Xu          , Xu          , Ur          , Xu          , Xu          , Xu          , Xu          , Xu          , Xu          , Uh          , Xu          
Uu          , Uu          , Uu^Ufi      , Uu          , Uu^Uf       , Uu          , Uu^Ufi      , Uu          , Uu          , Uu^Ii       , Uu          , Uu          , Uu^Vu       , Uu          , Uu^Cov      , 3 Uu^Kov    , Uu^Cov      , Uu          , Uu          , Uu          , Uu          , Uu          , Uu          , Uu          , Uu          , Uu          , Uu          , Xu          , Xu          , Xu          , Uu          , Uu^Uf       , Uu          , Uu          , Uu^Uf       , Uu          , Uu          , Uu          , Uu          , Uu          , Uu          , Xu          , Xu          , Uu          , Xu          , Qxu         , 6 Kud       , Xu          , Cud^Es      , Ur          , Cud^Es      , Cud^Es      , Uu          , Xu          , Uu          , Xu          , Uh          , Xu          
Uu          , Uu          , Uu^Ii       , Uu^Uf       , Uu^Ii       , Uu          , Uu^Uf       , Uu^Uf       , Uu          , Uu          , Uu          , Uu          , Uu          , Uu          , Uu          , Uu^Cov      , Uu          , Uu          , Uu          , Uu          , Uu          , Uu          , Uu          , Uu          , Qxu         , Uu          , Uu          , Uu          , Xu          , Xu          , Xu          , Uu          , Uu^Uf       , Uu^Uf       , Uu^Ii       , Uu^Uf       , Uu          , Uu          , Uu          , Uu          , Uu          , Uu          , Uu          , Uu          , Uu          , Qxu         , Qxu         , Cud^Es      , Cud^Es      , Cud^Es      , Cud^Es      , Cud^Es      , Uu          , Uu          , Uu          , Uu          , Uu          , Xu          
Ww          , Uu          , Uu          , Uu          , Uu^Uf       , Uu^Uf       , Uu          , Uu^Uf       , Uu^Ufi      , Uu          , Uu          , Uu          , Uu          , Uu^Vu       , Uu          , Uu          , Uu          , Ur          , Uu          , Uu          , Uu          , Uu          , Qxu         , Qxu         , Qxu         , Qxu         , Uu          , Uu          , Uu          , Xu          , Xu          , Uu          , Uu^Ii       , Uu          , Uu          , Uu^Ii       , Uu          , Uu^Ii       , Uu          , Uu          , Uu          , Uu          , Uu          , Uu          , Uu          , Qxu         , Ww          , Cud^Es      , Ur          , Cud^Ii      , Uu          , Uu          , Uu          , Uu          , Xu          , Uu          , Uu^Vu       , Xu          
Uu          , Ww          , Wwt         , Wwt^Ii      , Wwt         , Uu^Uf       , Uu          , Uu^Uf       , Uu          , Uu          , Wwt         , Wwt         , Wot^Es      , Wwt         , Uu          , Uu          , Uu^Vu       , Uu          , Uu^Vu       , Uu          , Uu          , Uu          , Ww          , Qxu         , Qxu         , Uu          , Uu          , Uu          , Uu          , Xu          , Xu          , Uu          , Uu          , Uu          , Uh          , Uh          , Uh          , Uu          , Uu          , Uu          , Uu          , Uu          , Uu          , Uu          , Ur          , Ww^Es       , Ww^Es       , Ur          , Uu          , Uu          , Uu          , Uu          , Uu          , Xu          , Xu          , Uu          , Ww          , Ww          
Uu          , Uu          , Uu          , Wwt         , Qxu         , Wwt         , Wwt         , Uu          , Wwt         , Wwt         , Wot         , Wwt         , Wwt^Es      , Wwt         , Uu          , Uu          , Uu          , Ur          , Uu          , Uu          , Uu          , Ww          , Ww^Es       , Ww          , Uu          , Uu          , Uu          , Uu          , Uu          , Xu          , Xu          , Uu          , Uu          , Uu          , Uh          , Uu          , Uh          , Uu          , Uu          , Uu          , Uu          , Uu          , Uu          , Ur          , Uu          , Xu          , Ww          , Xu          , Xu          , Xu          , Xu          , Xu          , Xu          , Uu          , Uu          , Uu          , Ww^Ii       , Xu          
Uu          , Uu          , Uu          , Uu          , Qxu         , Qxu         , Qxu         , Wwt         , Qxu         , Wwt         , Qxu         , Wot         , Wwt^Es      , Wwt         , Ww          , Uu          , Ur          , Ur          , Uu          , Uu          , Ww          , Ww          , Uu          , Uu          , Uu          , Uu          , Uu          , Uu          , Ur          , Xu          , Xu          , Uu          , Uu          , Uu          , Uh          , Uh          , Uu          , Ur          , Uu          , Uu          , Uu          , Ur          , Uu          , Uu          , Xu          , Xu          , Xu          , Ww          , Xu          , Xu          , Xu          , Xu          , Xu          , Uu          , Uu          , Uu          , Ww          , Xu          
Xu          , Uu          , Uu          , Uu          , Qxu         , Uu          , Uu          , Qxu         , Uu          , Qxu         , Qxu         , Qxu         , Qxu         , Uu          , Uu          , Ww          , Ww^Es       , Uu          , Uu          , Uu          , Ww          , Uu          , Uu          , Xu          , Uu          , Uu          , Xu          , Xu          , Xu          , Ur          , Uu          , Xu          , Uu          , Uu          , Uu          , Ur          , Uh          , Uh          , Uu          , Uu          , Uu          , Uu          , Uu          , Xu          , Qxu         , Xu          , Xu          , Ww          , Ww          , Xu          , Uu          , Qxu         , Qxu^Ii      , Xu          , Uu          , Uu          , Qxu         , Qxu         
Xu          , Uu          , Uu          , Uu          , Uu          , Qxu         , Qxu         , Qxu^Ii      , Qxu         , Qxu         , Qxu         , Uu          , Uu          , Qxu         , Uu          , Uu          , Uu          , Ww^Es       , Ww          , Ww          , Uu          , Uu          , Xu          , Xu          , Uu          , Uu          , Uu          , Xu          , Xu          , Xu          , Xu          , Uu          , Ur          , Uu          , Uu          , Ww          , Ww          , Ww          , Ww          , Uu          , Uu          , Uu          , Uu          , Uu          , Uu          , Qxu         , Xu          , Xu          , Uu          , Ww          , Ww          , Ww          , Uu          , Xu          , Uu          , Xu          , Qxu         , Qxu         
Xu          , Uu          , Uu          , Uu          , Uu          , Uu          , Uu          , Uu          , Uu          , Uu          , Uu          , Qxu         , Uu^Ii       , Qxu^Ii      , Qxu         , Uu          , Uu          , Uu          , Xu          , Ww          , Ww          , Uu          , Xu          , Xu          , Uu          , Xu          , Xu          , Uu          , Uu          , Xu          , Uu          , Uu          , Uu          , Uu          , Uu          , Ww          , Ww          , Ww          , Ww          , Ww          , Uu          , Uu          , Uu          , Uu          , Uu          , Uu          , Uu          , Uu          , Uu          , Uu          , Uu          , Ww          , Ww          , Uu          , Ww          , Ww          , Ww          , Qxu         
Xu          , Xu          , Uu          , Uu          , Uu          , Uu          , Uu          , Uu          , Uu^Ii       , Uu          , Uu          , Qxu         , Uu          , Uu          , Uu          , Uu          , Uu          , Ur          , Xu          , Xu          , Uu          , Ww^Es       , Ww          , Ww          , Uu^Ii       , Uu          , Xu          , Xu          , Uu          , Uu          , Uu          , Uu          , Uu          , Uu          , Uu          , Uu          , Ww          , Ww          , Uu          , Uu          , Uu          , Uu          , Uu          , Uu          , Uu^Ii       , Uu          , Uu          , Uu          , Xu          , Uu          , Uu          , Uu          , Uu          , Ww          , Qxu         , Qxu         , Xu          , Ww          
Xu          , Uu          , Uu          , Uu          , Uu          , Uu          , Qxu         , Qxu         , Xu          , Xu          , Uu          , Uu          , Qxu         , Qxu         , Qxu         , Uu          , Qxu         , Ur          , Uu          , Xu          , Xu          , Ww^Es       , Ww          , Uu          , Ww^Es       , Ww^Ii       , Xu          , Xu          , Uu          , Uu^Ii       , Uu          , Uu          , Ww          , Uu          , Ww          , Ww          , Xu          , Uu          , Uu          , Uu          , Uh          , Uu          , Uh          , Uu          , Uu          , Uu^Ii       , Uu          , Xu          , Xu          , Uu          , Ww          , Ww          , Ww          , Ww          , Xu          , Qxu         , Xu          , Xu          
Xu          , Xu          , Uu          , Uu          , Xu          , Qxu         , Xu          , Xu          , Uu          , Uu          , Uu          , Uu          , Qxu         , Qxu         , Qxu         , Uu          , Qxu         , Uu          , Uu          , Uu          , Xu          , Xu          , Uu          , Ww          , Xu          , Ww          , Xu          , Xu          , Ww          , Uu          , Ur          , Uu          , Ww          , Ww          , Ww          , Ww^Ii       , Xu          , Xu          , Uu          , Uh          , Uh          , Uh          , Uu          , Uu          , Uu          , Uu          , Xu          , Xu          , Xu          , Uu          , Ww          , Ww          , Ww          , Ww          , Uu^Ii       , Xu          , Uu          , Uu          
Ww          , Xu          , Uu          , Uu          , Xu          , Qxu         , Qxu         , Qxu         , Uu          , Uu          , Uu          , Uu          , Qxu         , Qxu         , Uu          , Uu          , Qxu         , Qxu         , Uu          , Uu          , Uu          , Xu          , Uu          , Ww          , Xu          , Ww          , Ww          , Ww          , Ww          , Ur          , Uu          , Uu          , Ww          , Ww          , Ww          , Ww          , Xu          , Xu          , Uu          , Uu          , Xu          , Uu          , Uh          , Uh          , Uu          , Uu          , Uu          , Uu          , Uu          , Ww          , Ww          , Ww          , Ww          , Ww          , Uu          , Uu          , Uu          , Uu          
Ww          , Ww          , Uu          , Uu          , Uu          , Uu          , Uu          , Uu          , Uu          , Uu          , Uu          , Uu          , Qxu         , Qxu         , Uu          , Uu          , Qxu         , Qxu         , Uu          , Ur          , Uu          , Uu          , Uu          , Ww          , Xu          , Xu          , Ww          , Ww          , Ur          , Ww^Es       , Ww          , Ww          , Ww          , Ww          , Ww          , Ww          , Ww          , Xu          , Xu          , Qxu         , Xu          , Xu          , Uu          , Uu          , Uu          , Uu          , Ww          , Ww          , Ww          , Ww          , Uh          , Ww          , Uu          , Uu          , Uu          , Uu          , Uu          , Uu          
Ww          , Ww          , Ww          , Uu          , Uu          , Uu          , Uu          , Uu          , Uu          , Uu          , Uu          , Uu          , Qxu         , Qxu         , Uu          , Uu          , Uu          , Uu          , Uu          , Uu          , Uu          , Uu          , Uu          , Ww          , Xu          , Xu          , Ww          , Ww          , Uu          , Uu          , Uu          , Uu          , Uu          , Uu          , Uu          , Uu          , Uu          , Ww          , Ww          , Xu          , Xu          , Uu          , Ww          , Uu          , Ww          , Ww          , Uh          , Uu          , Uh          , Uh          , Uu          , Ww          , Uu          , Uu          , Uu          , Uu          , Uu          , Uu          
Uu          , Ww          , Uu          , Ww          , Ww          , Uu          , Ww          , Ww          , Ww          , Uu          , Uu          , Uu          , Uu          , Uu          , Ur          , Ur          , Uu          , Uu          , Uu          , Uu          , Uu          , Uu          , Ww          , Ww          , Ww          , Ww          , Ww          , Uu          , Uu          , Uu          , Uu          , Uu          , Uu          , Uu          , Uu          , Uu^Ii       , Uu          , Uu          , Uu          , Ww          , Ww          , Ww          , Ww^Ii       , Ww          , Uh          , Uh          , Uh          , Uh          , Uh          , Uu          , Uh          , Ww          , Uu^Ii       , Uu          , Uu          , Uu          , Uu          , Uu          
Uu          , Uu          , Uu          , Uu          , Ww          , Ww          , Ww^Ii       , Ww          , Ww          , Uu          , Uu          , Uu          , Uu^Ii       , Uu          , Xu          , Xu          , Uu          , Uu          , Uu          , Ww          , Ww          , Ww          , Uu          , Uu          , Uu          , Uu          , Ww          , Ur          , Uu          , Uu          , Uu          , Uh          , Uu          , Uu          , Uh          , Uh          , Uu          , Uu          , Uu          , Uu          , Uu          , Uu          , Uu          , Ww          , Ww          , Uu          , Ww          , Ww          , Ww          , Uh          , Ww          , Ww          , Ww          , Uu          , Uu          , Uu          , Xu          , Xu          
Uu          , Uu          , Uu          , Ww          , Ww          , Uu          , Uu          , Ww          , Ww          , Ww          , Uu          , Uu          , Uu          , Uu          , Xu          , Xu          , Uu          , Uu          , Qxu         , Qxu         , Qxu         , Ww          , Qxu         , Uu          , Uu^Ii       , Ur          , Ww          , Uu          , Uu          , Uu          , Uh          , Uh          , Uh          , Uh^Ii       , Uh          , Uh          , Uu          , Uu          , Xu          , Xu          , Xu          , Xu          , Uu          , Uu          , Uu          , Ww          , Ww          , Ww          , Ww          , Ww          , Uh          , Uu          , Ww          , Uu          , Uu          , Uu          , Uu          , Xu          
Uu          , Uu          , Qxu         , Ww          , Qxu         , Uu          , Uu^Ii       , Uu          , Uu          , Ww          , Uu          , Uu          , Uu          , Uu          , Uu          , Xu          , Xu          , Uu          , Qxu         , Qxu         , Qxu         , Qxu         , Qxu         , Uu          , Uu          , Ww          , Ww          , Uu          , Uu          , Uh          , Uh          , Uh          , Uh          , Uh^Ii       , Uh          , Uu^Ii       , Uu          , Uu          , Uu          , Xu          , Uu          , Xu          , Uu          , Uh          , Uh          , Uu          , Ww          , Ww          , Uu          , Uh          , Uh          , Uu^Ii       , Ww          , Uu          , Xu          , Uu          , Uu          , Uu          
Uu          , Uu          , Qxu         , Qxu         , Uu          , Qxu         , Uu          , Uu          , Ww^Es       , Ww^Es       , Uu          , Uu          , Uu          , Uu          , Uu          , Xu          , Xu          , Uu          , Uu          , Uu          , Uh          , Qxu         , Uu          , Uu          , Uu          , Ww^Es       , Uu          , Uu          , Uu          , Uh          , Uh          , Uh          , Uh          , Uh          , Uu          , Uu          , Uu          , Uu          , Uu^Uf       , Uu^Ufi      , Uu          , Uu          , Uu          , Uu          , Uh          , Uh          , Uu          , Ww          , Ww          , Uu          , Uu          , Uh          , Ww          , Xu          , Xu          , Xu          , Uu          , Uu          
Xu          , Xu          , Uu          , Uu          , Qxu         , Qxu         , Uu          , Ww          , Xu          , Uu          , Xu          , Uu          , Uu          , Uu          , Uh          , Uh          , Uh          , Xu          , Xu          , Uh          , Uh          , Uu          , Uu          , Ur          , Ww          , Ww          , Xu          , Xu          , Uh          , Uu          , Uh          , Uu          , Uu          , Uu          , Uu          , Uu          , Uu          , Uu^Uf       , Uu^Ii       , Uu          , Uu          , Uu^Uf       , Uu^Ii       , Uu          , Uu          , Uh          , Uu          , Uu          , Uu          , Ww          , Ww          , Ww          , Ww          , Xu          , Uu          , Uu          , Xu          , Uu          
Uu          , Uu          , Uu          , Uu          , Uu          , Uu          , Ww          , Ww          , Xu          , Uu          , Xu          , Xu          , Xu          , Uu          , Uh          , Uh          , Uh          , Xu          , Xu          , Xu          , Xu          , Uh          , Uu          , Uu          , Ww          , Ww          , Xu          , Xu          , Xu          , Uh          , Uu          , Uu          , Uu          , Uu          , Uu          , Uu          , Uu          , Uu          , Uu          , Uu^Uf       , Uu          , Uu^Uf       , Uu          , Uu          , Uu          , Xu          , Xu          , Uu          , Xu          , Xu          , Xu          , Ww          , Ww          , Uu          , Ww^Es       , Uu          , Uu          , Xu          
Xu          , Xu          , Uh          , Uu          , Ww          , Ww          , Ww          , Ww          , Xu          , Uu          , Uu          , Xu          , Uh          , Ur          , Uh          , Uh          , Uh          , Xu          , Uu          , Uu          , Xu          , Uu          , Ur          , Ww          , Ww          , Ww          , Ww          , Xu          , Xu          , Uu          , Uu          , Uu          , Uu          , Uu          , Uu          , Uu          , Uu          , Uu          , Ww          , Ww          , Uu          , Uu^Ii       , Uu          , Uu          , Uu          , Xu          , Xu          , Xu          , Xu          , Xu          , Uu          , Uu          , Ww          , Ww          , Uu          , Ww^Es       , Ww^Es       , Uu          
Uh          , Xu          , Ww          , Ww          , Ww          , Ww          , Ww          , Xu          , Xu          , Xu          , Ww          , Ww^Es       , Ww^Es       , Uu          , Uu          , Uu^Ii       , Uu          , Uu          , Uh          , Uu          , Uh          , Uu          , Ww          , Ww^Es       , Uu          , Ww          , Xu          , Xu          , Uu          , Uu          , Uu          , Uu          , Uu          , Uu          , Uu          , Uu          , Uu          , Uu          , Ww          , Ww          , Xu          , Uu          , Uu          , Uu          , Ww          , Uu          , Uu          , Uu          , Ww          , Xu          , Ww          , Ww          , Xu          , Uu          , Uu          , Uu          , Ww          , Ww          
Uu          , Uh          , Ww          , Ww          , Ww          , Ww^Ii       , Ww          , Uh          , Uu          , Ww          , Ww          , Uu          , Ur          , Ww          , Ww          , Uu          , Uu          , Uu          , Uh          , Uh          , Qxu         , Ww          , Ww          , Uu          , Ur^Ii       , Ww          , Ww          , Uu          , Uu          , Uu          , Ww          , Ww          , Ww          , Ww          , Ww          , Uu          , Uu          , Uu          , Ww          , Ww          , Xu          , Uu          , Xu          , Xu          , Ww          , Ww          , Ww^Es       , Ww^Es       , Ww          , Ww          , Xu          , Xu          , Xu          , Uu          , Uu          , Uu          , Ww          , Uu          
Uh          , Uh          , Uh          , Uh          , Uh          , Uh          , Ww          , Uh          , Ww          , Ww          , Uu          , Uu          , Ur          , Uu          , Uu          , Ww          , Ww          , Uh          , Qxu^Ii      , Qxu         , Qxu         , Qxu         , Ww          , Ww          , Ww^Es       , Uu^Ii       , Ww          , Uu          , Uu          , Uu          , Ww          , Ww          , Ww          , Ww          , Uh          , Ww          , Ww          , Ww          , Ww          , Ww          , Ww          , Ww          , Ww          , Ww          , Ww^Es       , Ww          , Uu          , Uu          , Ww          , Xu          , Xu          , Xu          , Uu          , Uu          , Xu          , Xu          , Ww          , Ww          
Uh          , Uh          , Uh          , Uh          , Ww          , Ww          , Ww^Es       , Ww          , Uu          , Uu          , Uu          , Uu          , Uu          , Uu          , Uu          , Uu^Ii       , Ww          , Ww          , Qxu         , Qxu         , Ww          , Ww          , Ww          , Uu          , Uu^Uf       , Ww^Ii       , Uu          , Ww          , Ww          , Uu          , Uu          , Ww          , Uu          , Ww          , Uh          , Uh          , Uh          , Uh          , Ww          , Ww          , Ww          , Uu          , Uu          , Ww          , Ww^Es       , Ww^Es       , Uu^Es       , Uu^Vu       , Qxu         , Qxu         , Xu          , Xu          , Uu          , Uu          , Uu          , Xu          , Ww          , Uu          
Uh          , Uh          , Ww^Es       , Ww          , Ww^Es       , Xu          , Xu          , Uh          , Uu          , Uu          , Uu          , Ur          , Ur          , 1 Uu        , Uu          , Uu          , Ww          , Qxu         , Ww          , Ww          , Ww          , Ww          , Uu          , Uu          , Ur          , Uu          , Uu^Uf       , Uu^Vu       , Uu          , Ww          , Ww          , Ww          , Ww          , Ww          , Uh          , Uh          , Uh          , Uh          , Ww          , Ww          , Uu          , Uu^Vu       , Uu          , Ww^Es       , Ww^Es       , Ww^Es       , Uu^Cov      , Uu          , Uu          , Qxu         , Xu          , Uu          , Uu          , Uu          , Ww^Es       , Ww          , Uu          , Uu          
Uh          , Ww          , Ww          , Ww^Es       , Ww          , Xu          , Xu          , Xu          , Uu          , Uu          , Uu          , Uu          , Uu          , Uu          , Ur          , Uu          , Uu          , Ww          , Uu          , Uu          , Ur          , Uu^Uf       , Uu^Ii       , Uu          , Uu          , Uu^Ufi      , Uu^Cov      , Uu          , Uu          , Uu^Uf       , Uu          , Ww          , Ww          , Uh          , Uh          , Uh          , Uh          , Uh          , Uh          , Uu          , Uu          , Uu          , Uu^Vu       , Uu          , Uu          , Uu          , Uu^Cov      , 4 Uu^Kov    , Uu          , Qxu         , Uu          , Uu^Vu       , Uu          , Uu          , Ww          , Ww          , Uu          , Uu          
Ww          , Ww^Es       , Uh          , Ww^Es       , Uh          , Xu          , Xu          , Uu          , Uu          , Ur          , Xu          , Xu          , Xu          , Uu          , Uu          , Ur          , Uu          , Uu          , Uu          , Ur          , Uu          , Ur          , Uu          , Uu^Ufi      , Uu          , Uu^Cov      , 5 Uu^Kov    , Uu^Ii       , Uu          , Uu^Vu       , Uu          , Uu          , Uh          , Uh          , Uh          , Uh          , Uh          , Uh          , Uh          , Uh          , Uh          , Uu          , Uu          , Uu          , Uu          , Uu          , Uu          , Uu^Cov      , Uu          , Uu          , Uu          , Uu^Vu       , Uu          , Uu          , Qxu         , Qxu         , Xu          , Xu          
Xu          , Xu          , Uh          , Uh          , Uh          , Xu          , Uu          , Ur          , Xu          , Xu          , Xu          , Xu          , Uh          , Uh          , Uu          , Uu          , Uu          , Uu          , Uu          , Uu          , Uu          , Uu          , Xu          , Xu          , Uh          , Uu^Cov      , Uu          , Xu          , Xu          , Uu          , Uu          , Uu          , Uh          , Uh          , Uu          , Uh          , Uh          , Uh          , Uh          , Uh          , Uh          , Uh          , Uu          , Uu          , Uu          , Uu          , Uu          , Uu          , Uu          , Uu          , Uh          , Xu          , Xu          , Xu          , Xu          , Qxu         , Qxu         , Xu          
