border_size=1
usage=map

Aa^Fma      , Aa^Fma      , Aa^Fpa      , Aa^Fma      , Ha^Fpa      , Ha^Fpa      , Ai          , Ww          , Ms          , Ms          , Ms          , Ms          
Aa^Fma      , Aa^Fma      , Aa^Fma      , Aa^Fpa      , Ha^Fpa      , Ha^Fpa      , Ai          , Ww          , Ha          , Ha^Fpa      , Ms          , Ms          
Ha^Fpa      , Aa^Fma      , Ha^Fpa      , Aa^Fpa      , Aa^Fma      , Ha^Fma      , Ww          , Ww          , Aa^Fma      , Ha          , Ms          , Ms          
Ha^Fpa      , Ha^Fpa      , Aa          , Aa^Fma      , Ai          , Ai          , Ww          , Ai          , Ha^Fpa      , Ha^Fpa      , Ms          , Ms          
Ha^Fpa      , Ha^Fpa      , Aa^Fma      , Aa^Fma      , Ai          , Ww          , Ww          , Aa          , Cea         , Ha          , Ms          , Ha          
Aa^Fma      , Aa^Fma      , Aa^Fma      , Aa          , Ai          , Ww          , Ww          , Ai          , Ai          , Cea         , Uu          , Ha          
Aa^Fma      , Aa^Fma      , Aa^Fma      , Aa^Fda      , Ai          , Ww          , Ww^Es       , Cea         , Cea         , Cea         , Aa^Fma      , Urb         
Ha^Fpa      , Aa^Fpa      , Ha^Fpa      , Aa^Fma      , Ai          , Ww          , Ww^Bw/      , Aa          , Aa          , Cea         , Aa^Fma      , Aa^Fma      
Ha^Fpa      , Ha^Fpa      , Aa^Fda      , Aa          , Ai^Bw/      , Ww^Bw/      , Ww          , Aa          , Ms          , Ms          , Ms          , Ms          
Aa^Fma      , Aa^Fma      , Aa          , Aa          , Aa          , Ai          , Ww          , Ha^Fpa      , Ha^Fpa      , Ms          , Ms          , Ms          
Aa^Fma      , Aa^Fma      , Aa^Fma      , Aa          , Aa^Fda      , Ww          , Ww          , Ha^Fpa      , Ms          , Ms          , Ms          , Ms          
Aa^Fma      , Aa^Fma      , Aa^Fma      , Aa^Fma      , Aa^Fma      , Ww          , Ha^Fpa      , Ha^Fpa      , Ha^Fpa      , Ms          , Ms          , Ms          
