border_size=1
usage=map

Md          , Md          , Md          , Md          , Md          , Md          , Md          , Md          , Md          , Md          , Hd          , Dd          , Dd          , Dd          , Dd          , Dd          , Dd          , Dd          , Dd          , Dd          , Dd          , Dd^Efm      , Dd          , Hd          , Hd          , Dd          , Rd          , Rd          , Rd          , Hd          , Hd          , Md          , Hd          , Hd          , Hd^Edpp     , Hd          , Hd          , Ww          , Md          , Md          , Hd          , Ww          , Ww          , Hd          , Ww          , Ww          , Ww          , Ww          , Dd          , Rd          , Dd          
Md          , Md          , Hd          , Md          , Hd          , Hd          , Md          , Md          , Md          , Hd          , Hd          , Hd          , Hd          , Dd          , Dd^Edpp     , Dd          , Dd          , Hd          , Hd          , Dd          , Dd^Edpp     , Dd^Edpp     , Dd          , Dd          , Hd          , Dd          , Rd          , Hd          , Md          , Rd          , Rd          , Dd^Efm      , Dd          , Hd          , Hd          , Hd          , Wwf         , Wwf         , Md          , Md          , Dd^Edpp     , Hd          , Ww          , Ww          , Dd          , Dd^Edpp     , Dd          , Dd          , Rd          , Rd          , Dd          
Md          , Md          , Md          , Hd          , Hd          , Hd          , Hd          , Md          , Dd          , Dd          , Dd          , Dd          , Hd          , Dd^Edpp     , Dd          , Hd          , Dd          , Dd          , Dd^Edpp     , Dd^Efm      , Dd^Edpp     , Dd^Edpp     , Dd          , Dd          , Hd          , Hd          , Rd          , Hd          , Md          , Md          , Cd          , Rd          , 4 Cd        , Gs          , Wwf         , Wwr         , Gg          , Gg          , Gs          , Hd          , Gd^Gvs      , Gd^Gvs      , Dd^Edpp     , Dd          , Dd^Es       , Dd          , Rd          , Rd          , Rd          , Dd          , Dd          
Hd          , Md          , Hd          , Hd          , Hd          , Hd          , Dd          , Md          , Hd          , Hd          , Dd^Edpp     , Dd          , Hd          , Hd          , Rd          , Hd          , Dd          , Dd          , Dd^Edpp     , Dd^Edpp     , Dd          , Dd          , Dd          , Dd          , Dd          , Dd          , Rd          , Md          , Md          , Md          , Cd          , Cd^Kov      , Ww          , Wwr         , Gg          , Gg          , Md          , Gs          , Rd          , Dd^Vda      , Dd^Edpp     , Dd          , Dd          , Dd          , Rd          , Rd          , Dd          , Dd          , Dd          , Rd          , Rd          
Hd          , Hd          , Hd          , Dd          , Dd          , Dd          , Dd          , Hd          , Rd          , Dd          , Dd          , Dd          , Rd          , Rd          , Dd          , Rd          , Rd          , Dd          , Rd          , Dd          , Rd          , Rd          , Rd          , Dd^Edpp     , Rd          , Rd          , Hd          , Md          , Gg          , Ww          , Wo          , Ww          , Wo          , Wo          , Gd^Gvs      , Gd^Gvs      , Md          , Dd          , Rd          , Dd^Edpp     , Dd          , Dd          , Rd          , Rd          , Dd          , Dd          , Dd          , Dd          , Dd          , Dd          , Dd          
Dd          , Hd          , Hd          , Hd          , Dd          , Dd          , Rd          , Rd          , Hd          , Rd          , Rd          , Rd          , Dd          , Dd          , Hd          , Dd^Edpp     , Dd^Edpp     , Rd          , Dd^Edpp     , Rd          , Dd          , Dd          , Dd          , Rd          , Rd          , Hd          , Gd          , Gs          , Gd^Gvs      , Ww          , Wo          , Ww          , Gg^Efm      , Gg^Fet      , Gd^Gvs      , Gd^Gvs      , Gs          , Dd          , Rd          , Dd          , Rd          , Rd          , Dd          , Dd          , Dd          , Dd          , Dd          , Dd          , Dd          , Dd          , Dd          
Dd          , Dd          , Dd          , Hd          , Rd          , Rd          , Md          , Hd          , Hd          , Dd          , Dd^Edpp     , Dd          , Dd          , Hd          , Dd          , Dd^Edpp     , Dd          , Dd          , Dd          , Dd          , Dd^Edpp     , Dd^Edpp     , Dd          , Dd          , Dd^Edpp     , Rd          , Rd          , Gd^Gvs      , Gd^Gvs      , Ww          , Ww          , Ww          , Gd^Gvs      , Gd^Gvs      , Gd^Gvs      , Gd^Gvs      , Dd^Vda      , Dd          , Rd          , Rd          , Dd          , Dd          , Dd^Edpp     , Dd          , Dd          , Dd          , Dd          , Dd^Edpp     , Dd          , Dd          , Hd          
Dd          , Dd          , Rd          , Rd          , Hd          , Md          , Md          , Hd          , Dd          , Dd          , Dd          , Dd          , Dd^Edpp     , Dd          , Dd^Edpp     , Dd^Edpp     , Dd^Edpp     , Dd^Edpp     , Dd^Edpp     , Dd^Edpp     , Dd^Edpp     , Dd          , Dd          , Dd^Edpp     , Dd^Es       , Dd^Vda      , Gd^Gvs      , Rp          , Wwr^Bw\     , Ww          , Gg          , Gg^Efm      , Gd^Gvs      , Gd^Gvs      , Gd^Gvs      , Gd^Gvs      , Dd          , Rd          , Gd          , Dd          , Dd          , Dd^Edp      , Dd          , Hd          , Hd          , Hd          , Dd          , Dd          , Hd          , Dd          , Dd          
Rd          , Rd          , Dd          , Hd          , Hd          , Md          , Md          , Md          , Md          , Dd          , Md          , Dd^Edpp     , Dd^Es       , Dd^Edpp     , Dd          , Dd          , Dd          , Dd          , Dd^Edpp     , Dd          , Dd          , Dd^Edpp     , Dd          , Dd          , Hd          , Gd^Gvs      , Gd^Gvs      , Gd^Gvs      , Wwr         , Rp          , Rp          , Gs          , Rd          , Gd^Gvs      , Rd          , Dd^Vda      , Rd          , Rd          , Gd          , Dd          , Dd          , Dd^Edp      , Dd          , Hd          , Hd          , Dd          , Hd          , Hd          , Hd          , Hd          , Dd          
Dd          , Dd          , Dd          , Dd          , Dd          , Dd          , Dd          , Dd          , Md          , Md          , Md          , Dd          , Hd          , Dd          , Dd          , Hd^Edpp     , Hd          , Hd^Edpp     , Dd          , Dd          , Dd^Edpp     , Dd^Edpp     , Dd          , Dd          , Gs          , Gd^Gvs      , Wo          , Wo          , Gd^Gvs      , Gg^Efm      , Dd^Vda      , Rd          , Rd          , Rd          , Rd          , Rd          , Gs          , Gs          , Gd^Gvs      , Dd          , Dd^Edpp     , Dd^Edp      , Dd^Edp      , Dd          , Dd          , Dd          , Hd          , Hd          , Hd          , Dd          , Dd          
Dd          , Dd          , Dd          , Dd          , Dd          , Dd          , Dd          , Dd          , Hd          , Hd          , Dd          , Dd          , Dd          , Hd          , Md          , Hd          , Md          , Hd          , Md          , Dd          , Dd^Edpp     , Dd          , Dd          , Dd          , Gs          , Wo          , Gs          , Gd^Gvs      , Gd^Gvs      , Gd^Gvs      , Hd          , Rd          , Dd^Es       , Rd          , Rd          , Rd          , Dd^Vda      , Gd^Gvs      , Dd          , Dd^Edp      , Dd          , Dd^Edp      , Dd^Edp      , Hd          , Dd          , Dd          , Dd          , Hd          , Dd          , Dd          , Hd          
Dd          , Dd          , Dd          , Dd          , Dd          , Dd          , Dd          , Dd          , Dd          , Hd          , Dd          , Dd^Edpp     , Dd          , Hd          , Hd          , Md          , Md          , Md          , Hd          , Dd          , Dd^Edpp     , Dd^Edpp     , Dd^Edpp     , Gs          , Ww          , Ww          , Dd          , Dd          , Dd          , Dd          , Dd^Edpp     , Dd^Edpp     , Dd          , Dd^Vda      , Dd          , Dd          , Dd^Edpp     , Dd          , Dd          , Dd          , Dd          , Dd^Edp      , Dd          , Hd          , Dd          , Dd          , Dd          , Dd          , Hd          , Hd          , Hd          
Dd          , Dd          , Hd          , Dd          , Hd          , Dd          , Dd          , Dd^Edp      , Dd^Edp      , Dd          , Dd          , Dd^Edpp     , Dd          , Dd          , Dd          , Hd          , Dd          , Md          , Md          , Hd^Edpp     , Hd^Edpp     , Dd^Edpp     , Ww          , Ww          , Hd          , Hd^Edpp     , Dd^Edpp     , Dd          , Dd          , Dd          , Dd          , Dd          , Dd          , Dd          , Dd          , Dd          , Dd          , Dd          , Dd          , Dd          , Dd          , Dd          , Dd          , Hd          , Hd          , Dd          , Hd          , Hd          , Hd          , Hd          , Hd          
Dd          , Dd          , Hd          , Hd          , Md          , Hd          , Hd          , Dd          , Dd          , Dd          , Dd^Edp      , Dd          , Hd          , Hd          , Dd          , Dd          , Dd^Edpp     , Dd^Edpp     , Md          , Md          , Ww          , Ww^Es       , Hd          , Hd          , Hd          , Hd^Edpp     , Dd^Edpp     , Dd          , Hd          , Dd          , Dd          , Dd          , Dd^Edpp     , Dd          , Dd          , Dd          , Dd^Edpp     , Dd^Edpp     , Dd^Edpp     , Dd          , Dd          , Dd          , Hd          , Hd          , Hd          , Dd          , Dd          , Dd          , Hd          , Hd          , Hd          
Dd          , Dd          , Md          , Dd          , Md          , Md          , Hd          , Dd          , Dd          , Dd^Edp      , Dd^Edp      , Dd          , Dd          , Hd          , Cd          , Dd^Edpp     , Ww          , Hd^Edpp     , Ww          , Ww          , Hd^Edpp     , Hd^Edpp     , Hd^Edpp     , Hd          , Hd^Edpp     , Hd          , Dd^Edpp     , Hd          , Hd          , Hd          , Hd          , Hd          , Hd          , Dd^Edpp     , Hd          , Hd          , Dd          , Dd^Edpp     , Dd          , Dd          , Dd          , Dd          , Dd          , Hd          , Dd          , Dd          , Hd          , Dd          , Dd          , Hd          , Hd          
Dd          , Dd          , Md          , Md          , Hd          , Md          , Dd          , Dd          , Dd^Edp      , Dd          , Dd          , Dd          , Dd          , Dd          , Cd          , Ww          , Hd          , Ww          , Hd^Edpp     , Hd^Edpp     , Hd^Edpp     , Hd^Edpp     , Hd          , Hd          , Hd^Edpp     , Hd^Edpp     , Hd          , Hd          , Ydu         , Hd          , Ydu         , Hd          , Hd          , Hd          , Hd          , Hd          , Dd          , Dd          , Dd          , Dd          , Dd          , Dd          , Dd          , Hd          , Dd          , Hd          , Dd          , Hd          , Dd          , Hd          , Hd          
Dd          , Dd          , Hd          , Md          , Hd          , Dd          , Dd^Es       , Dd          , Dd          , Dd          , Hd          , Dd          , Dd          , Cd          , 2 Kd        , Ww          , Hd          , Md          , Md          , Md          , Md          , Md          , Md          , Md          , Ydu         , Ydu         , Ydu         , Ydu         , Ydu         , Ydu         , Ydu         , Ydu         , Hd          , Hd          , Hd          , Dd          , Dd          , Dd          , Dd^Edpp     , Dd^Edpp     , Dd          , Dd          , Dd          , Dd          , Dd          , Hd          , Dd          , Dd          , Dd          , Dd          , Dd          
Dd          , Dd          , Hd          , Hd          , Dd          , Dd          , Dd          , Dd          , Dd          , Hd          , Hd          , Hd          , Hd          , Hd          , Wwr         , Ww          , Hd          , Hd          , Md          , Md          , Hd          , Hd          , Ydu         , Ydu         , Ydu         , Ydu         , Ydu         , Ydu         , Ydu         , Ydu         , Ydu         , Hd          , Ydu         , Ydu         , Hd          , Dd          , Dd          , Dd^Edpp     , Dd          , Dd          , Dd          , Dd^Edpp     , Dd          , Hd          , Hd          , Dd          , Dd          , Dd          , Hd          , Hd          , Hd          
Dd          , Dd          , Dd          , Dd          , Dd          , Dd          , Dd          , Hd          , Hd          , Dd          , Hd          , Hd          , Ww          , Ww          , Hd          , Hd          , Ydu         , Md          , Dd          , Hd          , Ydu         , Ydu         , Ydu         , Ydu         , Ydu         , Ydu         , Ydu         , Ydu         , Ydu         , Ydu         , Ydu         , Ydu         , Ydu         , Ydu         , Hd          , Dd          , Dd^Edpp     , Dd          , Dd          , Dd          , Dd          , Dd          , Dd^Edpp     , Hd          , Hd          , Dd          , Hd          , Hd          , Hd          , Hd          , Hd          
Dd          , Dd          , Dd          , Dd          , Dd^Edp      , Dd          , Hd          , Dd          , Hd          , Ww          , Ww          , Ww^Es       , Dd          , Dd          , Dd          , Ydu         , Ydu         , Hd          , Dd          , Ydu         , Ydu         , Ydu         , Hd^Edpp     , Hd          , Hd          , Ydu         , Ydu         , Ydu         , Ydu         , Ydu         , Ydu         , Ydu         , Ydu         , Hd          , Hd          , Dd^Edpp     , Dd          , Dd          , Dd          , Dd          , Dd          , Dd          , Dd          , Hd          , Hd          , Dd          , Hd          , Hd          , Hd          , Hd          , Hd          
Dd          , Dd          , Dd^Edp      , Dd          , Dd          , Dd          , Hd          , Hd          , Ww          , Ww          , Hd          , Hd          , Dd          , Dd          , Dd          , Dd          , Hd          , Hd          , Hd^Edpp     , Ydu         , Ydu         , Hd          , Dd^Edpp     , Dd          , Dd          , Hd^Edpp     , Ydu         , Ydu         , Md          , Md          , Md          , Hd          , Hd          , Ydu         , Hd^Edpp     , Hd          , Dd          , Dd          , Dd          , Dd^Edpp     , Hd          , Dd          , Dd          , Hd          , Hd          , Dd          , Hd          , Hd          , Hd          , Hd          , Hd          
Dd          , Dd^Edp      , Dd^Edp      , Dd^Edp      , Dd^Edp      , Dd          , Dd          , Hd          , Ww^Es       , Hd          , Dd          , Hd          , Hd          , Dd          , Hd          , Dd          , Dd          , Hd          , Hd          , Ydu         , Ydu         , Hd          , Ydu         , Dd^Edpp     , Md          , Md          , Md          , Md          , Hd          , Md          , Hd          , Hd          , Dd          , Hd          , Dd          , Hd          , Dd          , Dd          , Dd          , Hd          , Hd          , Dd          , Dd          , Hd          , Hd          , Hd          , Hd          , Hd          , Dd          , Hd          , Hd          
Dd          , Dd^Edp      , Dd^Edp      , Dd          , Dd          , Dd          , Hd          , Hd          , Ww          , Dd          , Dd          , Dd          , Hd          , Hd          , Hd          , Dd          , Dd          , Hd          , Hd          , Hd          , Hd          , Hd          , Ydu         , Hd          , Md          , Md          , Dd^Edpp     , Hd          , Hd          , Hd          , Dd          , Dd          , Dd          , Dd          , Dd^Edpp     , Dd          , Dd          , Dd          , Hd          , Hd          , Md          , Hd          , Dd          , Hd          , Hd          , Hd          , Hd          , Dd          , Dd          , Hd          , Hd          
Dd          , Dd          , Dd          , Dd          , Dd          , Hd          , Hd          , Hd          , Ww          , Hd          , Hd          , Dd          , Dd          , Dd          , Dd^Edpp     , Hd          , Hd          , Hd          , Hd          , Hd          , Hd          , Ydu         , Ydu         , Md          , Md          , Md          , Hd          , Dd^Edpp     , Dd          , Dd          , Hd          , Dd^Edpp     , Dd          , Dd^Edpp     , Hd          , Dd          , Dd          , Hd          , Md          , Md          , Hd          , Dd^Edpp     , Dd^Edpp     , Hd          , Hd          , Hd          , Dd          , Dd          , Hd          , Dd          , Hd          
Dd          , Dd          , Dd          , Dd          , Dd          , Dd          , Dd^Es       , Dd          , Ww          , Ww          , Dd^Edpp     , Dd          , Dd          , Dd          , Dd          , Ydu         , Ydu         , Ydu         , Ydu         , Hd          , Ydu         , Ydu         , Ydu         , Ydu         , Hd          , Hd          , Dd^Do       , Dd^Edpp     , Dd          , Hd          , Hd          , Dd          , Dd          , Dd^Edpp     , Hd          , Dd          , Hd          , Md          , Hd          , Md          , Dd          , Dd^Edp      , Md          , Hd          , Hd          , Hd          , Dd          , Hd          , Hd          , Dd          , Hd          
Hd          , Dd          , Hd          , Hd          , Dd          , Dd          , Dd          , Dd          , Dd          , Ww          , Ww          , Dd          , Dd          , Dd^Edpp     , Dd^Edpp     , Ydu         , Ydu         , Ydu         , Ydu         , Ydu         , Ydu         , Ydu         , Hd          , Hd          , Dd          , Dd^Edpp     , Dd          , Dd          , Hd^Edpp     , Hd          , Hd          , Hd          , Dd          , Dd          , Md          , Md          , Md          , Md          , Dd          , Hd          , Md          , Hd          , Md          , Hd          , Dd          , Hd          , Dd          , Hd          , Hd          , Dd          , Hd          
Hd          , Hd          , Hd          , Hd          , Dd          , Dd          , Dd          , Dd          , Dd^Edp      , Dd          , Ww          , Dd          , Dd^Edpp     , Dd^Edpp     , Dd          , Hd          , Hd          , Ydu         , Hd          , Ydu         , Ydu         , Ydu         , Hd          , Hd          , Hd          , Dd^Edpp     , Hd          , Dd          , Dd          , Dd          , Hd          , Hd          , Hd          , Hd          , Dd^Edpp     , Md          , Hd          , Hd          , Hd          , Md          , Md          , Md          , Hd          , Hd          , Dd          , Hd          , Hd          , Dd          , Hd          , Dd          , Hd          
Hd          , Hd          , Dd          , Dd          , Hd          , Hd          , Hd          , Dd^Edp      , Dd          , Dd          , Ww          , Dd^Edpp     , Dd          , Dd          , Hd          , Hd          , Hd          , Hd          , Hd^Edpp     , Hd          , Hd          , Hd^Edpp     , Hd          , Dd          , Ydu         , Hd          , Ydu         , Hd          , Dd^Edpp     , Ydu         , Ydu         , Hd          , Ydu         , Dd^Edpp     , Ydu         , Hd^Edpp     , Hd          , Hd          , Dd^Edpp     , Dd^Edpp     , Cd          , 1 Kd        , Cd          , Dd          , Dd^Do       , Dd          , Hd          , Hd          , Hd          , Dd          , Hd          
Dd^Edp      , Dd          , Dd^Edp      , Dd          , Dd          , Dd          , Dd^Edp      , Dd          , Dd          , Dd          , Wwr^Es      , Dd          , Hd          , Dd          , Hd          , Hd          , Dd          , Ydu         , Ydu         , Hd          , Ydu         , Hd          , Ydu         , Ydu         , Ydu         , Ydu         , Ydu         , Dd^Edpp     , Dd          , Ydu         , Dd^Edpp     , Ydu         , Ydu         , Ydu         , Ydu         , Hd          , Ydu         , Ydu         , Ydu         , Hd          , Dd          , Cd          , Dd^Es       , Dd^Es       , Hd          , Hd          , Hd          , Hd          , Dd          , Dd          , Hd          
Dd^Edp      , Dd^Edp      , Dd^Edp      , Dd^Edp      , Dd          , Dd^Edp      , Dd          , Hd          , Cd          , Dd          , Wwr         , Hd          , Hd          , Dd          , Dd^Edpp     , Dd          , Hd          , Hd          , Ydu         , Ydu         , Ydu         , Ydu         , Ydu         , Ydu         , Hd          , Ydu         , Hd          , Hd          , Dd          , Dd          , Dd^Edp      , Ydu         , Hd          , Ydu         , Hd          , Hd^Edpp     , Hd          , Ydu         , Ydu         , Dd^Edpp     , Hd          , Dd          , Dd^Edp      , Dd          , Dd          , Hd          , Hd          , Dd          , Dd          , Dd          , Dd          
Hd          , Dd          , Dd^Edp      , Dd^Edp      , Hd          , Dd          , Dd          , Cd          , Ww          , Ww^Es       , Hd          , Hd          , Dd          , Dd          , Dd^Edpp     , Dd          , Dd^Edpp     , Hd          , Ydu         , Hd          , Hd          , Hd          , Hd^Edpp     , Hd          , Dd          , Dd          , Dd          , Hd^Edpp     , Hd          , Hd          , Dd          , Dd^Edp      , Hd          , Ydu         , Hd          , Md          , Md          , Hd          , Dd          , Ydu         , Dd^Edp      , Dd^Edp      , Dd          , Dd          , Hd          , Hd          , Md          , Dd          , Md          , Md          , Md          
Hd          , Hd          , Hd          , Dd          , Hd          , Hd          , Cd          , 3 Kd        , Ww          , Hd          , Dd          , Dd          , Dd          , Dd          , Dd^Edp      , Dd^Edpp     , Ydu         , Ydu         , Ydu         , Ydu         , Hd          , Hd^Edpp     , Hd          , Hd          , Dd          , Dd          , Hd          , Hd          , Dd^Do       , Hd          , Dd          , Hd          , Dd^Edpp     , Hd          , Hd          , Md          , Md          , Dd^Edpp     , Dd^Do       , Hd          , Dd          , Md          , Dd          , Dd          , Hd          , Md          , Md          , Md          , Md          , Md          , Dd          
Dd^Edp      , Dd          , Dd          , Hd          , Hd          , Hd          , Ww          , Ww          , Hd          , Hd          , Hd          , Dd          , Hd          , Hd          , Ydu         , Ydu         , Hd          , Dd^Edp      , Ydu         , Ydu         , Hd          , Hd          , Dd          , Dd          , Hd          , Hd          , Hd          , Hd          , Dd^Edp      , Dd          , Dd          , Dd          , Dd          , Hd          , Hd          , Hd          , Dd          , Dd^Edpp     , Md          , Dd^Edp      , Md          , Md          , Dd          , Hd          , Md          , Md          , Md          , Md          , Md          , Hd          , Dd          
Dd          , Dd          , Dd          , Hd          , Hd          , Ww          , Ww          , Hd          , Hd          , Hd          , Hd          , Dd          , Hd          , Ydu         , Ydu         , Hd          , Dd          , Hd          , Hd          , Hd          , Hd          , Dd          , Dd          , Dd          , Dd          , Hd          , Dd          , Dd          , Dd^Edp      , Dd^Edp      , Dd          , Hd          , Hd          , Dd          , Dd          , Dd          , Hd          , Md          , Md          , Md          , Md          , Hd          , Md          , Md          , Md          , Md          , Hd          , Md          , Hd          , Dd          , Hd          
Dd          , Dd^Edp      , Dd^Edp      , Dd          , Hd          , Ww          , Dd          , Hd          , Dd          , Hd          , Dd          , Dd          , Dd          , Ydu         , Dd          , Hd          , Hd          , Hd          , Hd          , Hd          , Dd          , Dd          , Dd          , Dd          , Dd          , Dd          , Dd          , Dd          , Dd          , Dd          , Dd          , Dd          , Dd          , Dd          , Dd          , Dd          , Dd          , Md          , Md          , Md          , Md          , Md          , Md          , Hd          , Hd          , Hd          , Hd          , Dd          , Dd          , Dd          , Hd          
