border_size=1
usage=map

Md          , Hh^Fms      , Hh^Fms      , Khr         , Md          , Md          , Mm          , Hh^Fds      , Hh^Fms      , Gg^Es       , Gg          , Ss          , Ww          , Ww          , Wwg         , Gs^Fms      , Gg^Es       , Gg          , Gg          , Gs^Fms      , Gs^Fms      , Hh^Fms      , Hh^Fms      , Gs^Fds      , Hh^Fms      , Gs^Fds      
Hh          , Md          , Hh          , Chr         , Gg          , Mm          , Hh          , Mm          , Gg^Es       , Gg          , Gg          , Ww          , Hh^Fds      , Hh^Fds      , Gs^Fms      , Wwg         , Wwg         , Wwg         , Wwg         , Wwg         , Gg          , Gg          , Gs^Fds      , Gs^Fds      , Gs^Fds      , Gg          
Hh^Fds      , Hh          , Gs^Fms      , Gg          , Gg          , Gg          , Gs^Fms      , Gs^Fms      , Gs^Fms      , Gg          , Gg          , Ww          , Gg          , Gg          , Gg          , Gg          , Wwg         , Gg^Es       , Gg          , Wwg         , Wwg         , Hh^Fms      , Hh^Fms      , Hh          , Mm          , Gg          
Gs^Fms      , Hh^Fds      , Gs^Fms      , Gs^Fms      , Gg          , Hh^Fds      , Gg          , Gs^Fms      , Gg          , Gg          , Ss          , Wwf         , Ss          , Ss          , Wwg         , Ss          , Wwg         , Ss^Xo       , Ss          , Wwg         , Wwg         , Ss          , Wwg         , Hh^Fms      , Hh^Fms      , Gs^Fds      
Hh^Fds      , Hh^Fp       , Gs^Fms      , Gg          , Gg          , Gg          , Ss          , Gg          , Ss          , Ss          , Ss          , Wwg         , Wwg         , Wwg         , Wwg         , Wwg         , Ss          , Ss          , Gg          , Hh^Fms      , Ss          , Ss          , Wwg         , Gs^Fms      , Hh          , Gs^Fds      
Gg          , Gs^Fms      , Gs^Fms      , Gg          , Gg          , Gg          , Wwg         , Wwg         , Wwg         , Ss          , Wwg         , Ss          , Ss          , Wwg         , Ss          , Wwg         , Wwg         , Wwg         , Wwg         , Gg          , Hh^Fp       , Ss          , Ss          , Hh          , Hh^Fds      , Gg          
Gg          , Gs^Fms      , Gg          , Gg          , Ss          , Ss          , Ss          , Ss          , Ss          , Wwg         , Ss          , Wwg         , Gg^Xo       , Gg          , Gg          , Wwg         , Ss          , Ss          , Ss          , Wwg         , Gg          , Gg          , Gg^Xo       , Ss          , Gs^Fms      , Gg          
Gs^Fms      , Gg          , Gg          , Gg          , Ss          , Wwg         , Gg^Efm      , Ss          , Wwg         , Wwg         , Ss          , Wwg         , Wwg         , Gg          , Gg          , Ss          , Gg          , Gg          , Gg          , Wwf         , Ss          , Gg          , Ss          , Gs^Fms      , Ss          , Ss          
Gs^Fms      , Gg          , Gg^Efm      , Ss          , Wwg         , Ss          , Wwg         , Ss          , Ss          , Ss          , Wwg         , Ss          , Wwg         , Ss          , Ss          , Ss          , Gg          , Gg          , Gg          , Gg          , Gg          , Wwg         , Wwg         , Ss          , Ss          , Ss          
Gg          , Gg          , Gg          , Ss          , Gg          , Ss          , Wwg         , Ss          , Ss          , Wwg         , Ss          , Wwg         , Gg          , Ss          , Gg          , Gg          , Gg          , Gg^Xo       , Gg          , Gg          , Gg          , Wwg         , Gg^Efm      , Wwg         , Gg          , Wwg         
Gg          , Gg          , Gg          , Ss          , Ss          , Gg          , Ss          , Gg          , Gg^Efm      , Gg^Xo       , Gg          , Wwf         , Ss          , Gg          , Gg          , Gg          , Gg          , Gg^Xo       , Gg          , Gg          , Gg          , Ss          , Ss          , Gg          , Gg          , Ss^Xo       
Gg          , Gg          , Gg^Efm      , Gg^Efm      , Ss          , Wwg         , Ss          , Ss          , Wwg         , Gg          , Ss          , Wwg         , Wwg         , Ss          , Gg          , Gg          , Gg          , Gg          , Re          , Gg          , Gg          , Wwg         , Ss          , Wwg         , Wwg         , Wwg         
Gg          , Gg          , Gg          , Ss          , Ss          , Wwg         , Gg          , Gg          , Ss          , Wwg         , Gg          , Ss          , Ss          , Wwg         , Ss          , Gg          , Gg^Efm      , Gg^Efm      , Re          , Gg          , Gg          , Wwg         , Ss          , Ss          , Ss          , Gg          
Gg          , Ss          , Ss          , Ss          , Ss          , Gg          , Wwg         , Ss          , Ss          , Ss          , Gg          , Ss          , Gg          , Gg          , Ss          , Gg          , Wwg         , Ss          , Gg          , Gg          , Wwf         , Ss          , Gg          , Wwg         , Gg          , Gg          
Gg          , Ss          , Wwg         , Wwg         , Ss          , Ss          , Ss          , Ss          , Ss          , Wwg         , Wwg         , Ss          , Gg^Xo       , Gg          , Gg^Efm      , Wwf         , Wwg         , Ss          , Gg          , Wwg         , Gg          , Gg          , Gg^Xo       , Gg          , Ss          , Gg          
Ww          , Ww          , Ww          , Ss          , Ss          , Ss          , Ss          , Ss          , Wwg         , Ss          , Gg          , Wwg         , Gg          , Gg          , Wwg         , Gg          , Ss          , Gg          , Re          , Gg          , Gg          , Gg          , Ss          , Ss          , Gg^Efm      , Gg          
Gg          , Ww          , Ww          , Ww          , Ww          , Wwg         , Ss          , Ss          , Ss          , Wwg         , Gg^Efm      , Gg          , Gg          , Gg          , Gg          , Wwg         , Wwg         , Ss          , Gg          , Gg          , Ww          , Gg          , Gg^Efm      , Wwg         , Ss          , Ss          
Gg          , Gg          , Ss          , Ww          , Ww          , Gg          , Ww          , Ww          , Ww          , Ww          , Ww          , Ss          , Ss^Xo       , Re          , Wwf         , Wwg         , Wwg         , Wwg         , Ss          , Gg          , Ss          , Gg          , Gg^Xo       , Wwg         , Wo          , Ss          
Gg          , Gg          , Gg          , Ss          , Gg          , Ww          , Wwg         , Ss          , Ss          , Ww          , Gg          , Ww          , Wwg         , Wwf         , Re          , Gg          , Gg          , Ww          , Ww          , Re          , Wwg         , Gg          , Ss          , Ss          , Wo          , Ss          
Gg          , Gg          , Gg          , Gg          , Gg          , Wwg         , Wwg         , Wwg         , Ss          , Gg          , Gg          , Ss          , Gg          , Gg          , Gg          , Re          , Gg          , Gg^Efm      , Gg^Efm      , Ww          , Re          , Ww          , Ww          , Ss          , Ww          , Wo          
Gs^Fds      , Gs^Fms      , Gg          , Gg          , Gg          , Ss          , Wwg         , Ss          , Gs^Fms      , Gs^Fms      , Gs^Fms      , Gg          , Gs^Vc       , Gg          , Gs^Fds      , Gg          , Gg          , Gg          , Gg          , Gg          , Re          , Gg          , Gg          , Ww          , Gg          , Gg          
Gs^Fds      , Gg          , Gs^Fms      , Gg          , Gs^Fds      , Gs^Fds      , Wwg         , Ss          , Gg          , Gs^Fms      , Gs^Fms      , Gg          , Gg          , Gs^Fds      , Gg          , Gg          , Gg          , 1 Gg        , Gg          , Gg          , Gg          , Gg          , Gg          , Gg          , Re          , Gg          
Hh^Fds      , Gs^Fds      , Gs^Fds      , Gg          , Gg          , Gs^Fms      , Wwg         , Gg          , Gg          , Gg          , Gg          , Gg          , Gs^Vc       , Gg          , Gg          , Gg          , Gs^Fds      , Gg          , Gg          , Gg          , Gs^Fms      , Gg          , Gg          , Gg          , Gg          , Gg          
Hh^Fp       , Gs^Fms      , Hh^Fms      , Wwg^Es      , Wwg         , Wwg         , Gg^Efm      , Gg          , Gg          , Gg          , Gg          , Gg          , Gg          , Gg          , Gg          , Gg          , Gs^Fds      , Gg          , Gg          , Gs^Fms      , Gg          , Gg          , Gg          , Gs^Vc       , Gg          , Gg          
Hh^Fds      , Hh^Fds      , Hh^Fms      , Wwg^Es      , Wwg         , Wwg         , Wwg         , Gs^Fms      , Gg          , Gg          , Gs^Fms      , Gg          , Gs^Fms      , Gs^Fms      , Gg          , Gs^Fds      , Gg          , Gs^Fds      , Gg          , Gg          , Gg          , Gg          , Gg          , Gg          , Gg          , Gg          
Gg          , Gg          , Gg          , Wwg^Es      , Wwg         , Wwg         , Wwg         , Gg          , Gg          , Gg          , Gg          , Gg          , Gg          , Gg          , Gg          , Gg          , Gg          , Gg          , Gg          , Gg          , Gg          , Gg          , Gs^Fms      , Gs^Fms      , Gs^Fms      , Gs^Fms      
