border_size=1
usage=map

Gg          , Gg          , Gg          , Gg          , Gg          , Gg          , Gg          , Gs^Fms      , Gs^Fds      , Gg          , Gs^Fms      , Re          , Gs^Fms      , Gs^Fms      , Gll^Fp      , Gg          , Gg          , Gg          , Gs^Fms      , Gs^Fms      , Ce          , Ce          , Gs^Fms      , Gg          , Gg          , Gg          , Gs^Fms      , Gs^Fms      , Gs^Fms      
Gg          , Gg          , Gg          , Gg          , Gs^Fds      , Gs^Fms      , Gll^Fp      , Gs^Fms      , Gs^Fms      , Gs^Fms      , Gs^Fms      , Re          , Gs^Fms      , Gg          , Gs^Fms      , Gs^Fds      , Gg          , Gs^Fms      , Gs^Fms      , Gs^Fms      , Ce          , Ce          , 1 Ke        , Ce          , Gs^Fms      , Gg          , Gg          , Gs^Fds      , Gs^Fms      
Ww          , Gg          , Gs^Fms      , Gs^Fms      , Gg          , Gg          , Gs^Fms      , Gs^Fds      , Gs^Fds      , Gg          , Gs^Fms      , Re          , Re          , Gs^Fms      , Re          , Gs^Fds      , Gs^Fms      , Gll^Fp      , Gs^Fds      , Gs^Fms      , Gs^Fms      , Ce          , Ce          , Ce          , Gg          , Gll^Fp      , Gg          , Gs^Fds      , Re          
Gs^Fms      , Ww          , Ww          , Gg          , Gg          , Gg          , Gs^Fms      , Gs^Fms      , Gg          , Gs^Fms      , Gg          , Gs^Fms      , Gg          , Re          , Re          , Gg          , Gg          , Gg          , Gg          , Gs^Fms      , Gs^Fms      , Gs^Fms      , Gg          , Gg          , Gs^Fms      , Gs^Fms      , Re          , Re          , Gg          
Gs^Fms      , Gs^Fms      , Gg          , Ww          , Ww          , Gs^Fms      , Gg          , Ww          , Ww          , Gg          , Gs^Fms      , Gs^Fms      , Gg          , Gg          , Gg          , Re          , Re          , Gs^Fms      , Gg          , Gg          , Gg          , Gs^Fms      , Gs^Fms      , Gs^Fms      , Re          , Re          , Gll^Fp      , Gs^Fds      , Gs^Fms      
Gs^Fms      , Gs^Fms      , Gg          , Gg          , Gs^Fms      , Ww          , Ww          , Ww          , Ww          , Ww          , Ww          , Gg          , Gg          , Gg          , Gg          , Gg          , Gg          , Re          , Gg          , Gs^Fms      , Gg          , Gg          , Re          , Re          , Gg          , Gg          , Gs^Fms      , Gs^Fms      , Gs^Fms      
Gg          , Gll^Fp      , Gs^Fms      , Gg          , Gs^Fms      , Ww          , Gg          , Gs^Fms      , Gg          , Gg          , Gs^Fms      , Ww          , Ww          , Gg          , Gg          , Gg          , Gg          , Re          , Gg          , Gg          , Re          , Re          , Gg          , Gg          , Gs^Fms      , Gg          , Gs^Fms      , Gg          , Gg          
Gg          , Gs^Fds      , Gg          , Gll^Fp      , Gll^Fp      , Gs^Fms      , Gs^Fms      , Gs^Fds      , Gs^Fds      , Gg          , Gs^Fms      , Gg          , Gg          , Ww          , Ww          , Gg          , Gg          , Re          , Re          , Re          , Gg          , Gg          , Gg          , Gs^Fms      , Gll^Fp      , Gg          , Gg          , Gg          , Ww          
Gg          , Gll^Fp      , Gs^Fms      , Gs^Fms      , Gs^Fms      , Gs^Fms      , Gll^Fp      , Gg          , Gs^Fms      , Gg          , Gs^Fms      , Gg          , Hh^Fms      , Gg          , Gg          , Ww          , Gg          , Re          , Gg          , Gg          , Gg          , Gg          , Gg          , Gs^Fms      , Ww          , Ww          , Ww          , Ww          , Gg          
Gg          , Gll^Fp      , Hh^Fds      , Gll^Fp      , Gll^Fp      , Gg          , Hh^Fms      , Gs^Fms      , Gs^Fms      , Hh^Fms      , Hh^Fms      , Hh^Fms      , Hh^Fms      , Hh^Fms      , Gs^Fms      , Ww          , Ww          , Re          , Gg          , Gg          , Gg          , Gg          , Ww          , Ww          , Gs^Fms      , Hh^Fms      , Gs^Fms      , Gs^Fms      , Hh^Fms      
Hh^Fms      , Hh^Fds      , Hh^Fms      , Gll^Fp      , Hh^Fms      , Hh^Fms      , Gll^Fp      , Hh^Fms      , Hh^Fms      , Hh^Fds      , Hh^Fds      , Hh^Fms      , Hh^Fms      , Hh^Fds      , Gs^Fms      , Gg          , Ww          , Rr          , Gg          , Gg          , Ww          , Ww          , Gg          , Gs^Fms      , Hh^Fms      , Hh^Fp       , Mm          , Gll^Fp      , Gll^Fp      
Gll^Fp      , Gll^Fp      , Hh^Fds      , Hh^Fp       , Mm          , Hh^Fds      , Hh^Fds      , Hh^Fms      , Mm          , Hh^Fp       , Mm          , Mm          , Mm          , Hh^Fds      , Hh^Fms      , Gs^Fms      , Ww          , Ww^Bsb|     , Ww          , Ww          , Mm          , Hh^Fms      , Hh          , Gs^Fms      , Mm          , Mm          , Gll^Fp      , Gll^Fp      , Gll^Fp      
Gll^Fp      , Gll^Fp      , Gll^Fp      , Gll^Fp      , Mm          , Mm          , Mm          , Mm          , Mm          , Mm          , Mm          , Mm          , Mm          , Mm          , Ww          , Gg          , Ww          , Ww^Bsb|     , Ww          , Mm          , Hh          , Mm          , Hh          , Mm          , Hh^Fp       , Gll^Fp      , Gll^Fp      , Gll^Fp      , Gll^Fp      
Gg          , Hh^Fms      , Mm          , Gll^Fp      , Gll^Fp      , Hh          , Hh          , Hh^Fp       , Hh^Fp       , Mm          , Mm          , Mm          , Mm          , Mm          , Ww          , Ww          , Ww          , Ww^Bsb|     , Ww          , Mm          , Mm          , Mm          , Mm          , Hh          , Mm          , Gll^Fp      , Mm          , Gll^Fp      , Gll^Fp      
Mm          , Mm          , Mm          , Gll^Fp      , Gll^Fp      , Hh^Fp       , Hh^Fds      , Mm          , Mm          , Mm          , Ww          , Ww          , Wo          , Ww          , Chr         , Ww          , Chr         , Ww^Bsb|     , Chr         , Chr         , Chr         , Gg          , Hh          , Hh^Fp       , Hh^Fp       , Mm          , Gll^Fp      , Mm          , Gll^Fp      
Mm          , Mm          , Mm          , Gll^Fp      , Mm          , Mm          , Mm          , Hh          , Gg          , Wo          , Wo          , Chr         , Chr         , Wo^Bsb/     , Ww          , Chr         , Ww          , Ww^Bsb|     , Chr         , Chr         , Wo          , Ww          , Mm          , Hh          , Mm          , Mm          , Gll^Fp      , Gll^Fp      , Gll^Fp      
Mm          , Mm          , Mm          , Mm          , Mm          , Mm          , Mm          , Chr         , Gg          , Wo          , Wo^Bw/      , Chr         , Chr         , Ww^Bsb\     , Chr         , Wo          , Chr         , Ww^Bsb|     , Wo          , Wo^Bsb\     , Chr         , Ww          , Mm          , Mm          , Mm          , Mm          , Mm          , Gs^Fms      , Gll^Fp      
Gg          , Hh^Fms      , Hh^Fms      , Mm          , Mm          , Mm          , Hh^Fms      , Hh^Fms      , Gg          , Re          , Wo          , Wo          , Wo          , Ww          , 2 Khr       , Chr         , Chr         , Ww^Bsb|     , Chr         , Chr         , Chr         , Mm          , Mm          , Mm          , Mm          , Mm          , Gs^Fms      , Gll^Fp      , Gll^Fp      
Gs^Fms      , Hh^Fds      , Hh^Fms      , Mm          , Mm          , Mm          , Hh^Vhh      , Hh^Fds      , Re          , Re          , Gg          , Wo          , Gg          , Wo          , Gg          , Wo          , Wo          , Wo^Bsb|     , Wo          , Wo          , Wo          , Gg          , Mm          , Mm          , Mm          , Mm          , Gll^Fp      , Gll^Fp      , Mm          
Gs^Fms      , Gs^Fms      , Gg          , Gg          , Gg          , Gs^Fms      , Gg          , Re          , Gs^Vh       , Re          , Re          , Gg          , Gs^Vh       , Gg          , Ww          , Ww          , Gg          , Rr          , Re          , Gg          , Gg          , Hh^Fms      , Mm          , Mm          , Mm          , Gll^Fp      , Gs^Fms      , Mm          , Mm          
Gg          , Gg          , Ww          , Ww          , Ss          , Gg          , Gg          , Gg          , Gg          , Gs^Fms      , Gs^Fms      , Re          , Gg          , Gg          , Ww          , Gg          , Gg          , Rr          , Re          , Re          , Re          , Hh^Vhh      , Hh^Fms      , Mm          , Mm          , Gs^Fms      , Mm          , Mm          , Mm          
Gg          , Gg          , Ww          , Ww          , Ss          , Gg          , Gg          , Gs^Vh       , Re          , Re          , Re          , Re          , Ww^Bw\      , Ww          , Gg          , Gg          , Re          , Rr          , Gg          , Gs^Vh       , Gs^Fms      , Gs^Fms      , Gs^Fms      , Hh^Fp       , Hh^Fds      , Mm          , Mm          , Mm          , Gg          
Gg          , Gg          , Gg          , Gg          , Ss          , Ss          , Ss          , Gg          , Gg          , Gg          , Ww          , Ww          , Gg          , Re          , Re          , Gs^Vh       , Re          , Rr          , Re          , Re          , Gs^Vh       , Gg          , Re          , Hh^Vhh      , Gs^Fms      , Hh^Fds      , Hh^Fms      , Gg          , Gg          
Ss          , Ss          , Ss          , Ss          , Ss          , Ss          , Ss          , Ss          , Gg          , Ww          , Ww          , Ww          , Gg          , Gs^Vh       , Gg          , Re          , Gg          , Rr          , Gg          , Re          , Re          , Re          , Gg          , Gg          , Gg          , Gg          , Gg          , Gg          , Gg          
Ss          , Ss          , Ss          , Ss          , Ss          , Ww          , Ss          , Ss          , Ww          , Ww          , Gg          , Ss          , Ss          , Gg          , Gg          , Gg          , Gg          , Rr          , Gg          , Gg          , Ss          , Gg          , Ss          , Gg          , Ss          , Gg          , Gg          , Gg          , Gg          
Ss          , Ss          , Ww          , Ww          , Ss          , Ss          , Ww          , Ss          , Ss          , Gg          , Gg          , Ss          , Gg          , Ss          , Gg          , Gg          , Rr          , Rr          , Gg          , Gg          , Ss          , Wwt         , Ss          , Ss          , Ss          , Gg          , Gg          , Gg          , Gg          
