border_size=1
usage=map

Mm          , Mm          , Mm          , Mm          , Mm          , Mm          , Mm          , Mm          , Mm          , Mm          , Mm          , Mm          , Mm          , Mm          , Mm          , Mm          , Mm          , Mm          , Mm          , Mm          , Mm          , Mm          , Mm          , Mm          , Mm          , Mm          , Mm          , Mm          , Mm          , Gg          , Mm          , Mm          , Mm          , Mm          , Mm          , Hh          , Hh          , Hh          , Gg          , Gg          , Gg          , Gg          , Gg          
Mm          , Mm          , Mm          , Mm          , Wo          , Mm          , Mm          , Mm          , Mm          , Mm          , Mm          , Mm          , Mm          , Mm          , Mm          , Mm          , Mm          , Mm          , Mm          , Mm          , Mm          , Mm          , Mm          , Mm          , Mm          , Mm          , Hh          , Mm          , Mm          , Mm          , Mm          , Mm          , Mm          , Mm          , Mm          , Mm          , Hh          , Hh          , Gg          , Gg          , Gg          , Gg          , Gg          
Gll^Fp      , Mm          , Gll^Fp      , Mm          , Wo          , Wo          , Wo          , Mm          , Gll^Fp      , Gll^Fp      , Gll^Fp      , Hh          , Hh          , Hh          , Hh          , Mm          , Gg          , Hh          , Gg          , Mm          , Hh          , Mm          , Mm          , Mm          , Hh^Fp       , Hh^Fms      , Hh^Fms      , Hh          , Hh^Fms      , Mm          , Mm          , Mm          , Mm          , Mm          , Mm          , Hh          , Hh^Fms      , Gg          , Gg          , Gs^Fms      , Gs^Fms      , Gg          , Gg          
Gg          , Gll^Fp      , Gg          , Wo          , Wo          , Wo          , Wo          , Wo          , Wo          , Gll^Fp      , Gll^Fp      , Hh          , Hh          , Hh          , Hh          , Hh          , Ss          , Ss          , Ss          , Gg          , Hh          , Hh^Fp       , Hh          , Hh          , Hh^Fms      , Hh^Fms      , Hh          , Hh          , Hh          , Hh          , Hh          , Mm          , Mm          , Mm          , Mm          , Hh          , Hh          , Hh          , Gg          , Gg          , Gg          , Gg          , Gg          
Gg          , Gg          , Wo          , Wo          , Wo          , Wo          , Wo          , Wo          , Wo          , Gg          , Gg          , Hh          , Ss          , Ss          , Ss          , Ss          , Ss          , Ss          , Ss          , Hh          , Hh          , Hh          , Hh          , Hh          , Hh          , Hh          , Hh          , Hh          , Hh          , Hh          , Hh          , Hh          , Hh^Fms      , Mm          , Mm          , Mm          , Hh          , Hh^Fms      , Gg          , Gs^Fms      , Gg          , Gg          , Gg          
Ss          , Ss          , Ss          , Wo          , Chr         , Ss          , Ss          , Ss          , Co          , Wo          , Ww          , Wwg         , Wwg         , Ss          , Ss          , Ss          , Ss          , Ss          , Ss          , Ss          , Ss          , Ss          , Ss          , Ss          , Ss          , Ss          , Ss          , Ss          , Ss          , Ss          , Ss          , Hh          , Hh          , Mm          , Mm          , Mm          , Hh          , Hh          , Gg          , Gs^Fms      , Gs^Fms      , Gg          , Gg          
Ss          , Ss          , Chr         , Chr         , Khr         , Chr         , Chr         , Co          , Co          , Co          , Co          , Co          , Co          , Wwg         , Ss          , Ss          , Wwg         , Chs         , 3 Khs       , Wwg         , Ss          , Ss          , Ss          , Ss          , Ss          , Ss          , Wwg         , Ss          , Ss          , Ss          , Ss          , Hh          , Hh          , Hh          , Hh          , Hh^Fms      , Hh^Fms      , Gg          , Gg          , Gs^Fms      , Ce          , Gg          , Gg          
Ss          , Ss          , Chr         , 2 Khr       , Khr         , Chr         , Ww          , Ww          , Ww          , Co          , Co          , Co          , Co          , Ss          , Wwg         , Wwg         , Ss          , Chs         , Ss^Bw\      , Ss          , Ss          , Ss          , Ss          , Wwg         , Wwg         , Wwg         , Ss          , Ss          , Ss          , Ss          , Ss          , Ss          , Ss          , Hh          , Gg          , Gg          , Gg          , Gg          , Gg          , Ce          , Ce          , Gg          , Gg          
Wwg         , Wwg         , Chr         , Khr         , Ww          , Chr         , Chr         , Ww          , Ww          , Ww          , Ww          , Co          , Co          , Ss          , Ss          , Ss          , Ss          , Ss          , Ss          , Ss^Bw\      , Chr         , Ss          , Ss          , Ss          , Ss          , Ss          , Ss          , Wwg         , Wwg         , Ss          , Ss          , Ss          , Wwg         , Gg          , Gg          , Gg          , Gg          , Gg          , Gg          , Ce          , Ke          , Gg          , Gg          
Ss          , Ss          , Chr         , Ww          , Ww          , Ww          , Ww          , Chr         , Chr         , Ww          , Ww          , Ww          , Ww          , Co          , Co          , Ss          , Chr         , Ss          , Chr         , Chr         , Chr         , Chr         , Chr         , Ss          , 8 Ko        , Ss          , Ss          , Ss          , Ss          , Wwg         , Wwg         , Wwg         , Ss          , Gs          , Gg          , Gg          , Gg          , Gg          , Gg          , Ce          , Gg          , Gg          , Gg          
Wwg         , Ss          , Co          , Co          , Co          , Ww          , Ww          , Ww          , Ww          , Chr         , Chr         , Ww          , Ww          , Ww          , Khr         , Chr         , Chr         , Chr         , Chr         , Chr         , Chr         , Chr         , Ww          , Co          , Co          , Ss          , Wwg         , Ss          , Ss          , Wwg         , Wwg         , Ss          , Ss          , Gs          , Gg          , Gg          , Gg          , Gg          , Gg          , Gg          , Gg          , Gg          , Gg          
Ss          , Ss          , Ss          , Co          , Co          , Co          , Co          , Ww          , Ww          , Ww          , Ww          , Chr         , Chr         , Khr         , Chr         , Chr         , Urb         , Urb         , Urb         , Urb         , Ss          , Ww          , Ww          , Ww          , Ww          , Co          , Co          , Ss          , Ss          , Ss          , Ss          , Ss          , Wwg         , Gg          , Gs          , Gg          , Gg          , Gg          , Gg          , Gg          , Gg          , Gg          , Gg          
Ss          , Ss          , Ss          , Ss          , Ss          , Co          , Co          , Co          , Co          , Ww          , Khr         , Khr         , Chr         , Chr         , Chr         , Chr         , Urb         , Urb         , Urb         , Urb         , Ss          , Ss          , Ww          , Ww          , Ww          , Co          , Ss          , Wwg         , Ss          , Ss          , Wwg         , Ss          , Ss          , Ss          , Gs          , Gs          , Gg          , Gg          , Gg          , 1 Gg        , Gg          , Gg          , Rr          
Ss          , Ss          , Ss          , Ss          , Ss^Bw/      , Ss^Bw/      , Wwg         , Ss          , Ss          , Co          , Ss          , Ss          , Ss          , Chr         , Urb         , Urb         , Urb         , Urb         , Urb         , Urb         , Urb         , Ss          , Ss          , Ss          , Co          , Co          , Ss          , Wwg         , Ss          , Wwg         , Ss          , Ss          , Ss          , Ss          , Ss          , Gg          , Gg          , Gg          , Gg          , Gg          , Rr          , Rr          , Rr          
Wwg         , Ss          , 7 Khs       , Chs         , Ss          , Ss          , Wwg         , Ss          , Ss          , Ss^Bw|      , Ss          , Ss          , Ss          , Chr         , Urb         , Urb         , Urb         , Urb         , Urb         , Urb         , Urb         , Urb         , Ur          , Co          , Rr          , Rr          , Rr          , Ss          , Ss          , Ss          , Wwg         , Ss          , Ss          , Ss          , Gg          , Gg          , Gg          , Gg          , Rr          , Rr          , Rr          , Rr          , Gg          
Ss          , Wwg         , Wwg         , Chs         , Ss          , Ss          , Wwg         , Ss          , Chs         , Ss^Bw|      , Wwg         , Wwg         , Ss          , Co          , Co          , Urb         , Urb         , Urb         , Urb         , Urb         , Co          , Ur          , Rr          , Rr          , Rr          , Rr          , Cud         , Wwg         , Ss          , Ss          , Ss          , Ss          , Ss          , Ss          , Gg          , Gg          , Rr          , Rr          , Rr          , Rr          , Gg          , Gg          , Ww          
Ss          , Wwg         , Ss          , Wwg         , Ss          , Wwg         , Ss          , Ss          , Ss          , 6 Khs       , Chs         , Ss          , Ss          , Co          , Ss          , Co          , Co          , Co          , Co          , Co          , Rr          , Rr          , Rr          , Rr          , Rr          , Cud         , Ss          , Chs         , Ss          , Ss          , Wwg         , Ss          , Ss          , Ss          , Rr          , Rr          , Rr          , Rr          , Gg          , Gg          , Ww          , Ww          , Gg          
Ss          , Ss          , Ss          , Ss          , Ss          , Ss          , Ss          , Ss          , Ss          , Ss          , Ss          , Ss          , Wwg         , Ss          , Ss          , Ss          , 5 Ko        , Ss          , Ss          , Rr          , Rr          , Rr          , Chs         , Rr          , Rr          , Rr          , Rr          , Ss          , Wwg         , Wwg         , Ss          , Wwg         , Ss^Bsb/     , Ss^Bsb/     , Ss^Bsb/     , Rr          , Ss          , Gg          , Ww          , Ww          , Gg          , Gg          , Gg          
Gg          , Ss          , Ss          , Ss          , Ss          , Ss          , Ss          , Wwg         , Ss          , Ss          , Ss          , Ss          , Wwg         , Ss          , Ss          , Ss          , Ss          , Ss          , Ss^Bw/      , Ss^Bw/      , Ss          , Chs         , Wwg         , Chs         , Ss          , Rr          , Wwg^Bsb\    , Ss^Bsb\     , Ss^Bsb\     , Ss          , Rr          , Rr          , Rr          , Wwg^Bsb/    , Wwg         , Ss          , Wwg         , Ww          , Gg          , Gg          , Gg          , Gg          , Gg          
Gg          , Gs          , Gg          , Ss          , Gs          , Ss          , Ss          , Ss          , Ss          , Ss          , Ss          , Ss          , Ss          , Ss          , Wog         , Wog         , Wog^Bw/     , Ss^Bw\      , Wog         , Ss          , Ss          , Wwg         , Ss          , Ss          , Ss          , Wwg         , Ss          , Ss^Bsb\     , Rr          , Rr          , Rr          , Rr          , Ss          , Ss          , Ss          , Wwg         , Ss          , Ss          , Ss          , Gg          , Gg          , Gg          , Gg          
Gg          , Gg          , Gg          , Gg          , Gg          , Gs          , Gg          , Ss          , Gs          , Gs          , Ss          , Ss          , Wog         , Wog         , Ss          , Ss^Bw/      , Ss          , Ss          , Ss          , Ss          , Wog         , Ss          , Wog         , Ss          , Ss          , Ss          , Ss          , Rr          , Rr          , Rr          , Rr          , Ss          , Ss          , Ss          , Ss          , Ss          , Ss          , Ss          , Ss          , Ss          , Ss          , Ss          , Ss          
Gs^Fms      , Gs^Fms      , Gs^Fms      , Gg          , Gs^Fms      , Gg          , Gg          , Gs          , Gg          , Gs          , Ss          , Ss          , Wog         , Ss          , Ss          , Ss^Bw\      , Gll         , Ss^Vhs      , Gg          , Ss          , Wwg         , Wog         , Ss          , Wog         , Ss          , Ss          , Ss^Bw/      , Ss^Bw/      , Chs         , Rr          , Chs         , Ss          , Ss          , Ss          , Wwg         , Wwg         , Ss          , Ss          , Ss          , Ss          , Ss          , Ss          , Ss          
Mm          , Gs^Fms      , Mm          , Hh^Fds      , Hh^Fds      , Gs^Fms      , Hh^Fds      , Gs^Fms      , Gs^Fms      , Gs          , Gg          , Ss          , Ss          , Ss          , Ss^Vhs      , Ss          , Ss          , Gll         , Gll         , Ss^Vhs      , Ss          , Wwg         , Ss^Bw\      , Ss          , Ss^Bw/      , Ss^Bw/      , Ss          , Ss          , Chs         , 4 Cud       , Chs         , Ss          , Ss          , Ss          , Ss          , Wwg         , Ss          , Ss          , Ss          , Ss          , Ss          , Ss          , Ss          
Mm          , Mm          , Mm          , Mm          , Mm          , Hh^Fds      , Hh^Fds      , Gg          , Hh^Fds      , Gg          , Gg          , Gs          , Ww          , Ss          , Ss          , Ss          , Ss^Vhs      , Gg          , Ss^Vhs      , Ss^Bw\      , Ss^Bw/      , Wwg^Bw/     , Wwg         , Ss^Bw/      , Ss          , Ss          , Ss          , Ss          , Ss          , Chs         , Ss          , Ss          , Ss          , Ss          , Ss          , Ss          , Ss          , Ss          , Ss          , Ss          , Ss          , Ss          , Ss          
Md          , Mm          , Md          , Mm          , Mm          , Mm          , Mm          , Hh^Fds      , Gs^Fms      , Hh^Fds      , Hh^Fds      , Gg          , Ww          , Gs          , Gg          , Ss          , Gs          , Ss          , Ss          , Ss          , Ss          , Ss          , Wwg         , Ss          , Ss          , Ss          , Ss          , Wwg         , Wwg         , Ss          , Ss          , Ss          , Ss          , Ss          , Wwg         , Ss          , Ss          , Wwg         , Ss          , Ss          , Ss          , Ss          , Ss          
Md          , Mm          , Mm          , Md          , Md          , Mm          , Mm          , Hh^Fds      , Mm          , Hh^Fds      , Hh^Fds      , Hh^Fds      , Ww          , Gs^Fms      , Hh^Fds      , Gg          , Gs^Fms      , Gs          , Gs          , Ss          , Ss          , Ss          , Wwg         , Wwg         , Ss          , Ss          , Wwg         , Ss          , Ss          , Ss          , Ss          , Ss          , Wwg         , Ss          , Ss          , Wwg         , Ss          , Ss          , Ss          , Ss          , Ss          , Ss          , Ss          
Md          , Mm          , Mm          , Mm          , Mm          , Md          , Mm          , Mm          , Mm          , Md          , Ww          , Ww          , Mm          , Hh^Fds      , Hh^Fds      , Hh^Fds      , Gs^Fms      , Gs          , Gs^Fms      , Wwg         , Ss          , Wwg         , Ss          , Ss          , Ss          , Wwg         , Ss          , Wwg         , Ss          , Ss          , Ss          , Ss          , Ss          , Ss          , Ss          , Ss          , Ss          , Ss          , Ss          , Ss          , Ss          , Ss          , Ss          
Md          , Mm          , Gg          , Mm          , Mm          , Mm          , Mm          , Mm          , Ww          , Ww          , Md          , Mm          , Ss          , Mm          , Mm          , Mm          , Gs^Fms      , Gs^Fms      , Gs          , Gs          , Ss          , Ss          , Ss          , Ss          , Ss          , Ss          , Ss          , Ss          , Ss          , Ss          , Ss          , Ss          , Ss          , Ss          , Ss          , Ss          , Ss          , Ss          , Ss          , Ss          , Ss          , Ss          , Ss          
